GEOID,NAME,hispanic_men,male_under_18,female_under_18,hispanic_men_margin,male_under_18_margin,female_under_18_margin,children,children_margin
01001020100,"Census Tract 201, Autauga County, Alabama",13,185,229,15,59,75,414,95.42536350467836
01001020200,"Census Tract 202, Autauga County, Alabama",0,289,130,12,86,58,419,103.73041983911952
01001020300,"Census Tract 203, Autauga County, Alabama",130,421,386,140,145,115,807,185.06755523321746
01001020400,"Census Tract 204, Autauga County, Alabama",14,368,344,23,102,113,712,152.22680447279973
01001020500,"Census Tract 205, Autauga County, Alabama",148,1458,1220,124,290,292,2678,411.5385765636072
01001020600,"Census Tract 206, Autauga County, Alabama",109,542,509,156,167,117,1051,203.90684147423792
01001020700,"Census Tract 207, Autauga County, Alabama",155,472,402,151,177,157,874,236.59670327373541
01001020801,"Census Tract 208.01, Autauga County, Alabama",34,403,360,45,114,92,763,146.4923206178399
01001020802,"Census Tract 208.02, Autauga County, Alabama",184,1529,1391,185,341,332,2920,475.9254143245557
01001020900,"Census Tract 209, Autauga County, Alabama",26,546,759,42,180,265,1305,320.3513695928269
01001021000,"Census Tract 210, Autauga County, Alabama",20,255,367,34,105,96,622,142.2708684165525
01001021100,"Census Tract 211, Autauga County, Alabama",23,302,338,40,116,102,640,154.46682491719702
01003010100,"Census Tract 101, Baldwin County, Alabama",0,406,261,12,165,132,667,211.303099835284
01003010200,"Census Tract 102, Baldwin County, Alabama",0,346,393,12,115,149,739,188.2179587605816
01003010300,"Census Tract 103, Baldwin County, Alabama",58,939,892,84,284,268,1831,390.486875579705
01003010400,"Census Tract 104, Baldwin County, Alabama",30,597,694,34,183,215,1291,282.33667845322543
01003010500,"Census Tract 105, Baldwin County, Alabama",0,644,358,17,213,162,1002,267.6060537431842
01003010600,"Census Tract 106, Baldwin County, Alabama",31,380,666,47,163,190,1046,250.3377718203947
01003010701,"Census Tract 107.01, Baldwin County, Alabama",231,1174,868,155,289,223,2042,365.0342449688796
01003010703,"Census Tract 107.03, Baldwin County, Alabama",140,3128,2578,153,732,460,5706,864.53687023747
01003010704,"Census Tract 107.04, Baldwin County, Alabama",16,871,1121,25,296,342,1992,452.3052066912341
01003010705,"Census Tract 107.05, Baldwin County, Alabama",158,1004,1279,136,268,323,2283,419.7058493754882
01003010800,"Census Tract 108, Baldwin County, Alabama",0,757,718,17,264,231,1475,350.7948118202434
01003010903,"Census Tract 109.03, Baldwin County, Alabama",18,700,694,17,96,139,1394,168.92897915988246
01003010904,"Census Tract 109.04, Baldwin County, Alabama",404,664,550,271,249,167,1214,299.81661061388843
01003010905,"Census Tract 109.05, Baldwin County, Alabama",448,1149,865,220,373,188,2014,417.6996528607607
01003010906,"Census Tract 109.06, Baldwin County, Alabama",384,693,690,257,216,226,1383,312.62117650600703
01003011000,"Census Tract 110, Baldwin County, Alabama",261,417,545,201,118,207,962,238.27085428142487
01003011101,"Census Tract 111.01, Baldwin County, Alabama",506,1431,1665,300,278,316,3096,420.880030412468
01003011102,"Census Tract 111.02, Baldwin County, Alabama",107,596,651,94,202,172,1247,265.3073689138694
01003011201,"Census Tract 112.01, Baldwin County, Alabama",2,712,689,5,307,230,1401,383.60005213763986
01003011202,"Census Tract 112.02, Baldwin County, Alabama",108,565,646,113,142,216,1211,258.49564793241683
01003011300,"Census Tract 113, Baldwin County, Alabama",26,591,541,38,195,145,1132,243.00205760445732
01003011401,"Census Tract 114.01, Baldwin County, Alabama",540,1269,926,204,453,323,2195,556.3613933406954
01003011403,"Census Tract 114.03, Baldwin County, Alabama",241,674,1182,216,269,302,1856,404.4317000434066
01003011405,"Census Tract 114.05, Baldwin County, Alabama",0,278,199,12,97,92,477,133.6899397860587
01003011406,"Census Tract 114.06, Baldwin County, Alabama",0,261,162,12,123,95,423,155.4155719353759
01003011407,"Census Tract 114.07, Baldwin County, Alabama",33,180,374,54,114,173,554,207.18349355100662
01003011408,"Census Tract 114.08, Baldwin County, Alabama",8,41,4,11,46,7,45,46.52956049652737
01003011501,"Census Tract 115.01, Baldwin County, Alabama",451,629,527,315,206,168,1156,265.81948762270986
01003011502,"Census Tract 115.02, Baldwin County, Alabama",662,1326,1170,383,336,337,2496,475.88338907761846
01003011601,"Census Tract 116.01, Baldwin County, Alabama",125,723,403,96,291,134,1126,320.3700984798675
01003011602,"Census Tract 116.02, Baldwin County, Alabama",127,403,376,169,218,171,779,277.0649743291274
01003990000,"Census Tract 9900, Baldwin County, Alabama",0,0,0,12,12,12,0,16.97056274847714
01005950100,"Census Tract 9501, Barbour County, Alabama",0,330,443,12,105,100,773,145
01005950200,"Census Tract 9502, Barbour County, Alabama",54,252,191,34,82,61,443,102.20078277586722
01005950300,"Census Tract 9503, Barbour County, Alabama",2,172,140,4,90,59,312,107.61505470890214
01005950400,"Census Tract 9504, Barbour County, Alabama",174,245,366,86,78,93,611,121.37956994486346
01005950500,"Census Tract 9505, Barbour County, Alabama",107,404,304,84,147,107,708,181.81859090863068
01005950600,"Census Tract 9506, Barbour County, Alabama",57,306,256,70,105,79,562,131.40015220691336
01005950700,"Census Tract 9507, Barbour County, Alabama",0,127,185,12,59,69,312,90.78546139112804
01005950800,"Census Tract 9508, Barbour County, Alabama",5,239,298,8,84,132,537,156.46085772486356
01005950900,"Census Tract 9509, Barbour County, Alabama",211,586,463,137,152,140,1049,206.64946164943183
01007010001,"Census Tract 100.01, Bibb County, Alabama",0,331,185,12,139,115,516,180.40509970618902
01007010002,"Census Tract 100.02, Bibb County, Alabama",43,542,657,52,154,184,1199,239.9416595758227
01007010003,"Census Tract 100.03, Bibb County, Alabama",0,568,451,12,205,183,1019,274.79810770818636
01007010004,"Census Tract 100.04, Bibb County, Alabama",227,1162,735,120,268,199,1897,333.80383460949037
01009050101,"Census Tract 501.01, Blount County, Alabama",646,773,823,232,209,209,1596,295.57063453597686
01009050102,"Census Tract 501.02, Blount County, Alabama",402,909,743,99,253,193,1652,318.2106220728654
01009050200,"Census Tract 502, Blount County, Alabama",505,597,645,151,124,155,1242,198.4968513604183
01009050300,"Census Tract 503, Blount County, Alabama",538,418,646,189,130,163,1064,208.4922060893404
01009050400,"Census Tract 504, Blount County, Alabama",129,426,349,134,144,141,775,201.5365971728212
01009050500,"Census Tract 505, Blount County, Alabama",413,940,973,104,160,213,1913,266.4000750750645
01009050601,"Census Tract 506.01, Blount County, Alabama",0,748,431,12,205,125,1179,240.10414407085938
01009050602,"Census Tract 506.02, Blount County, Alabama",72,879,1158,50,181,224,2037,287.98784696580515
01009050700,"Census Tract 507, Blount County, Alabama",177,1137,794,222,236,234,1931,332.3431961090824
01011952100,"Census Tract 9521, Bullock County, Alabama",0,249,237,12,115,119,486,165.48715962273326
01011952200,"Census Tract 9522, Bullock County, Alabama",4,534,690,8,132,171,1224,216.0208323287363
01011952500,"Census Tract 9525, Bullock County, Alabama",111,308,110,169,145,95,418,173.34935823359717
01013952700,"Census Tract 9527, Butler County, Alabama",33,177,180,46,88,96,357,130.23056476879765
01013952800,"Census Tract 9528, Butler County, Alabama",0,132,116,12,53,58,248,78.56844150166147
01013952900,"Census Tract 9529, Butler County, Alabama",64,248,257,60,108,95,505,143.83671297690307
01013953000,"Census Tract 9530, Butler County, Alabama",0,251,119,12,80,75,370,109.65856099730654
01013953100,"Census Tract 9531, Butler County, Alabama",0,225,513,12,106,162,738,193.59752064528098
01013953200,"Census Tract 9532, Butler County, Alabama",0,441,418,12,176,146,859,228.67444107289296
01013953300,"Census Tract 9533, Butler County, Alabama",0,158,211,12,65,71,369,96.26006440887103
01013953400,"Census Tract 9534, Butler County, Alabama",6,302,245,9,115,105,547,155.72411502397438
01013953500,"Census Tract 9535, Butler County, Alabama",0,271,191,12,96,70,462,118.81077392223317
01015000200,"Census Tract 2, Calhoun County, Alabama",12,150,263,20,96,140,413,169.75276139138356
01015000300,"Census Tract 3, Calhoun County, Alabama",0,239,313,12,85,132,552,157
01015000400,"Census Tract 4, Calhoun County, Alabama",0,432,439,12,234,123,871,264.35771220072246
01015000500,"Census Tract 5, Calhoun County, Alabama",0,66,112,12,41,74,178,84.59905436823747
01015000600,"Census Tract 6, Calhoun County, Alabama",7,261,168,12,91,67,429,113.00442469213318
01015000700,"Census Tract 7, Calhoun County, Alabama",106,251,322,77,124,90,573,153.21879780235844
01015000800,"Census Tract 8, Calhoun County, Alabama",1,76,123,4,50,55,199,74.33034373659252
01015000900,"Census Tract 9, Calhoun County, Alabama",12,393,392,21,151,129,785,198.600100704909
01015001000,"Census Tract 10, Calhoun County, Alabama",166,519,725,147,173,215,1244,275.9601420495358
01015001100,"Census Tract 11, Calhoun County, Alabama",334,1158,814,224,237,235,1972,333.7573969217761
01015001201,"Census Tract 12.01, Calhoun County, Alabama",24,222,294,29,86,81,516,118.1397477566293
01015001202,"Census Tract 12.02, Calhoun County, Alabama",653,553,523,228,178,158,1076,238.00840321299583
01015001300,"Census Tract 13, Calhoun County, Alabama",91,171,180,82,69,59,351,90.78546139112804
01015001400,"Census Tract 14, Calhoun County, Alabama",31,339,284,51,92,138,623,165.8553586713435
01015001500,"Census Tract 15, Calhoun County, Alabama",22,577,671,26,191,165,1248,252.40047543536838
01015001600,"Census Tract 16, Calhoun County, Alabama",70,463,401,115,115,127,864,171.3300907604966
01015001700,"Census Tract 17, Calhoun County, Alabama",133,946,651,152,216,220,1597,308.3115307606902
01015001800,"Census Tract 18, Calhoun County, Alabama",199,1045,790,155,191,197,1835,274.3902330623304
01015002000,"Census Tract 20, Calhoun County, Alabama",55,1027,746,53,233,194,1773,303.1913587159106
01015002101,"Census Tract 21.01, Calhoun County, Alabama",17,72,121,22,38,69,193,78.77182237323191
01015002102,"Census Tract 21.02, Calhoun County, Alabama",33,324,289,37,104,96,613,141.53444810363305
01015002103,"Census Tract 21.03, Calhoun County, Alabama",73,694,603,55,230,211,1297,312.1233730434169
01015002200,"Census Tract 22, Calhoun County, Alabama",91,308,377,114,158,147,685,215.8077848456816
01015002300,"Census Tract 23, Calhoun County, Alabama",71,493,371,61,141,122,864,186.45374761586316
01015002400,"Census Tract 24, Calhoun County, Alabama",56,472,472,55,124,138,944,185.52627846210896
01015002501,"Census Tract 25.01, Calhoun County, Alabama",0,499,871,17,164,279,1370,323.6309626719916
01015002502,"Census Tract 25.02, Calhoun County, Alabama",2,520,506,5,123,133,1026,181.1573901335521
01015002600,"Census Tract 26, Calhoun County, Alabama",58,530,331,98,152,111,861,188.2153022471871
01015981901,"Census Tract 9819.01, Calhoun County, Alabama",0,0,0,12,12,12,0,16.97056274847714
01015981902,"Census Tract 9819.02, Calhoun County, Alabama",0,0,0,12,12,12,0,16.97056274847714
01015981903,"Census Tract 9819.03, Calhoun County, Alabama",0,0,0,12,12,12,0,16.97056274847714
01017953800,"Census Tract 9538, Chambers County, Alabama",0,359,389,12,111,189,748,219.18485349129398
01017953900,"Census Tract 9539, Chambers County, Alabama",130,262,411,93,117,149,673,189.44656238633627
01017954000,"Census Tract 9540, Chambers County, Alabama",81,621,581,104,157,163,1202,226.31394124092313
01017954200,"Census Tract 9542, Chambers County, Alabama",10,384,336,21,110,113,720,157.69908052997647
01017954300,"Census Tract 9543, Chambers County, Alabama",27,542,592,41,209,218,1134,302.00165562460086
01017954400,"Census Tract 9544, Chambers County, Alabama",0,32,83,12,32,76,115,82.46211251235322
01017954500,"Census Tract 9545, Chambers County, Alabama",45,494,327,80,149,174,821,229.0785891348207
01017954600,"Census Tract 9546, Chambers County, Alabama",114,316,424,106,131,151,740,199.90497742677644
01017954700,"Census Tract 9547, Chambers County, Alabama",6,502,410,11,179,129,912,220.6399782451041
01019955701,"Census Tract 9557.01, Cherokee County, Alabama",0,341,252,12,113,89,593,143.8401890988746
01019955702,"Census Tract 9557.02, Cherokee County, Alabama",28,356,379,44,116,120,735,166.90116836020053
01019955800,"Census Tract 9558, Cherokee County, Alabama",131,572,561,95,175,164,1133,239.83536019528063
01019955900,"Census Tract 9559, Cherokee County, Alabama",0,326,403,12,104,136,729,171.20747647226156
01019956000,"Census Tract 9560, Cherokee County, Alabama",10,365,359,20,201,133,724,241.0186714758838
01019956100,"Census Tract 9561, Cherokee County, Alabama",0,654,677,17,280,202,1331,345.2593228285081
01021060101,"Census Tract 601.01, Chilton County, Alabama",117,360,499,191,171,281,859,328.9407241434237
01021060102,"Census Tract 601.02, Chilton County, Alabama",328,777,938,229,227,329,1715,399.71239660535923
01021060200,"Census Tract 602, Chilton County, Alabama",28,348,220,41,163,146,568,218.82641522448793
01021060300,"Census Tract 603, Chilton County, Alabama",30,361,530,37,99,130,891,163.40440630533806
01021060401,"Census Tract 604.01, Chilton County, Alabama",103,641,711,52,139,158,1352,210.440015206234
01021060402,"Census Tract 604.02, Chilton County, Alabama",1217,1436,1152,358,316,296,2588,432.9803690700076
01021060500,"Census Tract 605, Chilton County, Alabama",5,443,413,8,132,124,856,181.10770276274835
01021060600,"Census Tract 606, Chilton County, Alabama",135,402,546,118,156,246,948,291.29366625452053
01021060700,"Census Tract 607, Chilton County, Alabama",0,495,363,12,177,158,858,237.26145915424192
01023956700,"Census Tract 9567, Choctaw County, Alabama",0,270,314,12,81,93,584,123.3288287465668
01023956800,"Census Tract 9568, Choctaw County, Alabama",25,336,454,28,140,115,790,181.1767093199344
01023956900,"Census Tract 9569, Choctaw County, Alabama",0,443,288,12,86,124,731,150.90394295710104
01023957000,"Census Tract 9570, Choctaw County, Alabama",1,316,182,4,92,67,498,113.81124724736128
01025957500,"Census Tract 9575, Clarke County, Alabama",0,135,86,12,66,47,221,81.02468759581859
01025957601,"Census Tract 9576.01, Clarke County, Alabama",5,115,112,7,57,55,227,79.20858539325141
01025957602,"Census Tract 9576.02, Clarke County, Alabama",11,605,480,18,224,155,1085,272.3986049890858
01025957700,"Census Tract 9577, Clarke County, Alabama",0,135,270,12,85,123,405,149.5125412799876
01025957800,"Census Tract 9578, Clarke County, Alabama",0,587,414,12,193,111,1001,222.64321233758733
01025957901,"Census Tract 9579.01, Clarke County, Alabama",0,404,322,12,176,127,726,217.03686322834653
01025957902,"Census Tract 9579.02, Clarke County, Alabama",0,404,503,12,147,163,907,219.49487465542333
01025958001,"Census Tract 9580.01, Clarke County, Alabama",0,106,344,12,60,134,450,146.81961721786362
01025958002,"Census Tract 9580.02, Clarke County, Alabama",18,155,110,25,85,65,265,107.00467279516349
01027958900,"Census Tract 9589, Clay County, Alabama",44,627,599,80,212,112,1226,239.76655313033135
01027959000,"Census Tract 9590, Clay County, Alabama",119,311,318,80,114,132,629,174.41330224498358
01027959100,"Census Tract 9591, Clay County, Alabama",0,309,235,12,148,71,544,164.14932226482082
01027959200,"Census Tract 9592, Clay County, Alabama",31,173,206,63,102,100,379,142.84257068535277
01029959500,"Census Tract 9595, Cleburne County, Alabama",9,431,406,13,100,108,837,147.18695594379278
01029959600,"Census Tract 9596, Cleburne County, Alabama",15,388,571,19,100,170,959,197.2308292331602
01029959700,"Census Tract 9597, Cleburne County, Alabama",134,347,347,43,129,118,694,174.82848738120455
01029959800,"Census Tract 9598, Cleburne County, Alabama",13,545,348,15,109,100,893,147.92227688891217
01031010100,"Census Tract 101, Coffee County, Alabama",22,286,233,23,50,57,519,75.82216034906945
01031010200,"Census Tract 102, Coffee County, Alabama",30,130,204,44,46,55,334,71.7007670809734
01031010300,"Census Tract 103, Coffee County, Alabama",98,572,500,51,82,82,1072,115.96551211459379
01031010400,"Census Tract 104, Coffee County, Alabama",21,172,120,32,55,42,292,69.20260110718382
01031010500,"Census Tract 105, Coffee County, Alabama",0,495,366,12,117,134,861,177.89041570584965
01031010600,"Census Tract 106, Coffee County, Alabama",7,128,146,10,51,49,274,70.7248188403477
01031010700,"Census Tract 107, Coffee County, Alabama",77,195,199,52,40,45,394,60.207972893961475
01031010800,"Census Tract 108, Coffee County, Alabama",93,304,300,48,56,76,604,94.40338976964757
01031010900,"Census Tract 109, Coffee County, Alabama",66,341,204,56,94,63,545,113.1591799192624
01031011000,"Census Tract 110, Coffee County, Alabama",243,550,350,146,102,129,900,164.45364088398895
01031011100,"Census Tract 111, Coffee County, Alabama",77,218,218,73,82,66,436,105.26157893552613
01031011201,"Census Tract 112.01, Coffee County, Alabama",274,1098,1114,121,192,184,2212,265.9323222175146
01031011202,"Census Tract 112.02, Coffee County, Alabama",567,1250,1464,171,226,236,2714,326.7598506548808
01031011300,"Census Tract 113, Coffee County, Alabama",439,572,530,156,192,185,1102,266.62520511009456
01033020100,"Census Tract 201, Colbert County, Alabama",101,336,266,84,143,90,602,168.9644933114647
01033020200,"Census Tract 202, Colbert County, Alabama",21,262,156,24,108,66,418,126.57013865837392
01033020300,"Census Tract 203, Colbert County, Alabama",0,259,211,12,105,102,470,146.38647478507022
01033020400,"Census Tract 204, Colbert County, Alabama",9,185,167,17,62,48,352,78.40918313565064
01033020500,"Census Tract 205, Colbert County, Alabama",162,678,649,121,204,219,1327,299.2941696725815
01033020600,"Census Tract 206, Colbert County, Alabama",73,679,445,93,163,136,1124,212.2851855405836
01033020701,"Census Tract 207.01, Colbert County, Alabama",162,674,766,134,219,238,1440,323.4269623887285
01033020703,"Census Tract 207.03, Colbert County, Alabama",0,560,532,12,210,195,1092,286.574597618142
01033020704,"Census Tract 207.04, Colbert County, Alabama",80,501,433,83,101,119,934,156.0833110873805
01033020801,"Census Tract 208.01, Colbert County, Alabama",0,306,334,12,107,123,640,163.02760502442524
01033020802,"Census Tract 208.02, Colbert County, Alabama",9,398,277,15,213,115,675,242.06197553519223
01033020901,"Census Tract 209.01, Colbert County, Alabama",5,428,628,6,129,154,1056,200.89051744669283
01033020902,"Census Tract 209.02, Colbert County, Alabama",99,381,298,76,118,114,679,164.07315441594946
01033021000,"Census Tract 210, Colbert County, Alabama",77,284,460,115,139,127,744,188.2817038376273
01035960200,"Census Tract 9602, Conecuh County, Alabama",0,233,229,12,112,109,462,156.28499608087785
01035960300,"Census Tract 9603, Conecuh County, Alabama",0,227,214,12,123,55,441,134.73678042761748
01035960400,"Census Tract 9604, Conecuh County, Alabama",11,296,260,15,95,119,556,152.2694979304785
01035960500,"Census Tract 9605, Conecuh County, Alabama",31,121,119,52,94,90,240,130.13838787997952
01035960600,"Census Tract 9606, Conecuh County, Alabama",0,557,348,12,218,137,905,257.4742705592153
01037961000,"Census Tract 9610, Coosa County, Alabama",0,473,248,12,126,67,721,142.70599146496969
01037961100,"Census Tract 9611, Coosa County, Alabama",0,207,295,12,76,76,502,107.48023074035522
01037961200,"Census Tract 9612, Coosa County, Alabama",33,304,274,33,91,109,578,141.9929575718458
01039961600,"Census Tract 9616, Covington County, Alabama",48,639,412,48,173,123,1051,212.26869764522513
01039961700,"Census Tract 9617, Covington County, Alabama",68,387,415,56,143,100,802,174.49641830135081
01039961800,"Census Tract 9618, Covington County, Alabama",39,283,268,33,100,91,551,135.20724832641184
01039961900,"Census Tract 9619, Covington County, Alabama",25,260,155,37,70,57,415,90.27181176868004
01039962000,"Census Tract 9620, Covington County, Alabama",12,428,373,16,103,124,801,161.19863522995473
01039962100,"Census Tract 9621, Covington County, Alabama",21,254,240,32,130,80,494,152.64337522473747
01039962300,"Census Tract 9623, Covington County, Alabama",57,296,500,57,96,127,796,159.20113064925135
01039962400,"Census Tract 9624, Covington County, Alabama",0,334,328,12,134,95,662,164.2589419179364
01039962500,"Census Tract 9625, Covington County, Alabama",38,87,131,44,41,62,218,74.33034373659252
01039962600,"Census Tract 9626, Covington County, Alabama",4,177,301,8,65,104,478,122.64175471673585
01039962700,"Census Tract 9627, Covington County, Alabama",22,246,185,31,93,79,431,122.0245876862528
01039962800,"Census Tract 9628, Covington County, Alabama",2,199,177,4,73,71,376,101.83319694480774
01039962900,"Census Tract 9629, Covington County, Alabama",6,254,177,7,73,76,431,105.38026380684383
01039963000,"Census Tract 9630, Covington County, Alabama",58,368,289,51,100,80,657,128.06248474865697
01041963400,"Census Tract 9634, Crenshaw County, Alabama",3,208,297,8,71,78,505,105.47511554864494
01041963500,"Census Tract 9635, Crenshaw County, Alabama",15,295,178,22,71,86,473,111.5212984142491
01041963600,"Census Tract 9636, Crenshaw County, Alabama",18,336,264,29,89,88,600,125.15989773086265
01041963700,"Census Tract 9637, Crenshaw County, Alabama",4,451,380,6,96,118,831,152.11837495845134
01041963800,"Census Tract 9638, Crenshaw County, Alabama",7,161,187,8,67,76,348,101.31633629380802
01041963900,"Census Tract 9639, Crenshaw County, Alabama",0,171,178,12,79,59,349,98.60020283954795
01043964100,"Census Tract 9641, Cullman County, Alabama",68,639,923,66,264,307,1562,404.90122252223443
01043964200,"Census Tract 9642, Cullman County, Alabama",108,747,794,67,219,219,1541,309.7127701597078
01043964300,"Census Tract 9643, Cullman County, Alabama",262,580,563,146,168,140,1143,218.6869909253863
01043964400,"Census Tract 9644, Cullman County, Alabama",23,338,501,26,109,158,839,191.9505144562004
01043964500,"Census Tract 9645, Cullman County, Alabama",10,606,511,14,177,135,1117,222.60727750906977
01043964600,"Census Tract 9646, Cullman County, Alabama",137,591,318,117,152,121,909,194.28072472584614
01043964700,"Census Tract 9647, Cullman County, Alabama",182,718,739,92,194,198,1457,277.2002886001384
01043964800,"Census Tract 9648, Cullman County, Alabama",144,542,428,111,149,153,970,213.56497840235883
01043964900,"Census Tract 9649, Cullman County, Alabama",96,808,826,89,168,196,1634,258.14724480420085
01043965000,"Census Tract 9650, Cullman County, Alabama",317,586,697,202,143,171,1283,222.91253890259293
01043965100,"Census Tract 9651, Cullman County, Alabama",66,342,442,70,132,142,784,193.8762491900439
01043965200,"Census Tract 9652, Cullman County, Alabama",79,416,206,74,91,61,622,109.55363982999378
01043965300,"Census Tract 9653, Cullman County, Alabama",30,528,543,42,136,132,1071,189.52572384771415
01043965401,"Census Tract 9654.01, Cullman County, Alabama",17,307,233,25,116,108,540,158.4929020492716
01043965402,"Census Tract 9654.02, Cullman County, Alabama",163,337,403,154,121,118,740,169.01183390520322
01043965500,"Census Tract 9655, Cullman County, Alabama",104,772,388,113,295,135,1160,324.4225639501667
01043965600,"Census Tract 9656, Cullman County, Alabama",24,242,319,28,98,135,561,166.82026255823962
01043965700,"Census Tract 9657, Cullman County, Alabama",23,295,477,39,104,156,772,187.48866632412745
01045020000,"Census Tract 200, Dale County, Alabama",453,812,928,151,164,132,1740,210.52315787105226
01045020100,"Census Tract 201, Dale County, Alabama",28,388,290,32,100,91,678,135.20724832641184
01045020200,"Census Tract 202, Dale County, Alabama",0,221,128,12,77,68,349,102.7277956543408
01045020300,"Census Tract 203, Dale County, Alabama",0,156,338,12,67,100,494,120.37026210821342
01045020400,"Census Tract 204, Dale County, Alabama",113,405,104,123,119,51,509,129.46814279968643
01045020500,"Census Tract 205, Dale County, Alabama",37,190,217,37,69,65,407,94.79451460923254
01045020700,"Census Tract 207, Dale County, Alabama",0,251,444,12,107,142,695,177.80044994318772
01045020801,"Census Tract 208.01, Dale County, Alabama",131,376,312,100,122,95,688,154.62535367784935
01045020802,"Census Tract 208.02, Dale County, Alabama",70,407,472,56,128,154,879,200.24984394500785
01045021101,"Census Tract 211.01, Dale County, Alabama",379,612,518,119,173,103,1130,201.34050759844627
01045021102,"Census Tract 211.02, Dale County, Alabama",163,409,365,120,153,142,774,208.7414668914636
01045021200,"Census Tract 212, Dale County, Alabama",157,328,262,123,118,124,590,171.1724276862369
01045021300,"Census Tract 213, Dale County, Alabama",28,467,560,30,100,106,1027,145.72576985557495
01045021400,"Census Tract 214, Dale County, Alabama",153,812,613,104,142,131,1425,193.19679086361657
01047956100,"Census Tract 9561, Dallas County, Alabama",0,647,591,17,162,186,1238,246.6576574931336
01047956201,"Census Tract 9562.01, Dallas County, Alabama",0,209,315,12,97,126,524,159.0125781188394
01047956202,"Census Tract 9562.02, Dallas County, Alabama",0,235,248,12,77,69,483,103.39245620450265
01047956300,"Census Tract 9563, Dallas County, Alabama",16,420,520,34,144,195,940,242.40668307618913
01047956400,"Census Tract 9564, Dallas County, Alabama",0,436,441,12,187,211,877,281.93970986719836
01047956500,"Census Tract 9565, Dallas County, Alabama",0,373,303,12,168,151,676,225.88713996153035
01047956600,"Census Tract 9566, Dallas County, Alabama",80,240,312,91,93,93,552,131.52186130069785
01047956701,"Census Tract 9567.01, Dallas County, Alabama",54,203,259,77,133,83,462,156.77372228788855
01047956702,"Census Tract 9567.02, Dallas County, Alabama",0,238,197,12,95,87,435,128.81770064707723
01047956800,"Census Tract 9568, Dallas County, Alabama",2,417,266,4,134,121,683,180.54639292990598
01047956900,"Census Tract 9569, Dallas County, Alabama",27,261,292,42,127,134,553,184.6212338816963
01047957000,"Census Tract 9570, Dallas County, Alabama",42,217,174,38,136,100,391,168.80758276807353
01047957100,"Census Tract 9571, Dallas County, Alabama",16,109,203,23,86,100,312,131.89389675038038
01047957200,"Census Tract 9572, Dallas County, Alabama",0,73,118,12,103,118,191,156.6301375853319
01047957300,"Census Tract 9573, Dallas County, Alabama",0,671,441,12,190,250,1112,314.00636936215164
01049960100,"Census Tract 9601, DeKalb County, Alabama",0,683,458,17,145,164,1141,218.908656749796
01049960200,"Census Tract 9602, DeKalb County, Alabama",161,372,298,136,158,119,670,197.80040444852483
01049960300,"Census Tract 9603, DeKalb County, Alabama",479,1113,894,314,256,226,2007,341.4849923495907
01049960400,"Census Tract 9604, DeKalb County, Alabama",67,594,692,86,169,194,1286,257.2877766237642
01049960500,"Census Tract 9605, DeKalb County, Alabama",117,691,624,108,148,159,1315,217.22108553268947
01049960600,"Census Tract 9606, DeKalb County, Alabama",203,799,547,122,214,164,1346,269.6145396672813
01049960700,"Census Tract 9607, DeKalb County, Alabama",1251,905,1329,384,323,372,2234,492.65911135388535
01049960800,"Census Tract 9608, DeKalb County, Alabama",865,660,663,226,170,165,1323,236.90715480964266
01049960900,"Census Tract 9609, DeKalb County, Alabama",317,351,508,119,114,131,859,173.65770930194836
01049961000,"Census Tract 9610, DeKalb County, Alabama",195,561,516,130,133,153,1077,202.72641663088706
01049961100,"Census Tract 9611, DeKalb County, Alabama",179,461,351,175,172,142,812,223.0425968284982
01049961200,"Census Tract 9612, DeKalb County, Alabama",192,262,283,181,67,89,545,111.40017953306898
01049961300,"Census Tract 9613, DeKalb County, Alabama",1077,1085,879,307,198,227,1964,301.21918929576844
01049961400,"Census Tract 9614, DeKalb County, Alabama",397,511,420,181,155,116,931,193.60010330575756
01051030100,"Census Tract 301, Elmore County, Alabama",70,770,390,41,267,157,1160,309.7385994673573
01051030200,"Census Tract 302, Elmore County, Alabama",0,551,343,12,168,150,894,225.21989254948153
01051030300,"Census Tract 303, Elmore County, Alabama",0,212,195,12,98,98,407,138.59292911256333
01051030400,"Census Tract 304, Elmore County, Alabama",117,602,979,108,220,257,1581,338.3031185194721
01051030500,"Census Tract 305, Elmore County, Alabama",19,454,562,33,136,166,1016,214.59729728027799
01051030600,"Census Tract 306, Elmore County, Alabama",0,925,658,17,300,227,1583,376.20340243012157
01051030701,"Census Tract 307.01, Elmore County, Alabama",65,1150,1407,85,240,224,2557,328.2925524589311
01051030702,"Census Tract 307.02, Elmore County, Alabama",10,457,266,16,142,99,723,173.1040149736568
01051030800,"Census Tract 308, Elmore County, Alabama",69,741,694,88,268,261,1435,374.09223461601016
01051030901,"Census Tract 309.01, Elmore County, Alabama",117,861,943,67,230,244,1804,335.3147774852758
01051030902,"Census Tract 309.02, Elmore County, Alabama",111,358,405,100,113,145,763,183.83144453547658
01051031000,"Census Tract 310, Elmore County, Alabama",297,972,967,228,300,296,1939,421.4451328464952
01051031100,"Census Tract 311, Elmore County, Alabama",83,625,436,102,133,104,1061,168.8342382338369
01051031200,"Census Tract 312, Elmore County, Alabama",15,130,178,23,50,71,308,86.83893136145792
01051031300,"Census Tract 313, Elmore County, Alabama",159,423,575,98,163,262,998,308.56603831270866
01053969800,"Census Tract 9698, Escambia County, Alabama",225,530,554,161,161,182,1084,242.99176940793694
01053969900,"Census Tract 9699, Escambia County, Alabama",20,533,480,28,146,134,1013,198.17164277464119
01053970100,"Census Tract 9701, Escambia County, Alabama",165,571,562,133,203,145,1133,249.46743274423616
01053970200,"Census Tract 9702, Escambia County, Alabama",0,159,148,12,84,77,307,113.95174417269794
01053970300,"Census Tract 9703, Escambia County, Alabama",38,425,433,70,157,145,858,213.71476317746513
01053970400,"Census Tract 9704, Escambia County, Alabama",53,413,358,55,150,114,771,188.403821617291
01053970500,"Census Tract 9705, Escambia County, Alabama",0,645,472,12,267,118,1117,291.91265817021366
01053970600,"Census Tract 9706, Escambia County, Alabama",0,571,529,12,154,221,1100,269.3640659033792
01053970700,"Census Tract 9707, Escambia County, Alabama",0,307,598,12,174,276,905,326.2698269837406
01055000200,"Census Tract 2, Etowah County, Alabama",60,412,271,38,140,83,683,162.75441622272496
01055000300,"Census Tract 3, Etowah County, Alabama",49,427,376,45,161,130,803,206.93235609734887
01055000400,"Census Tract 4, Etowah County, Alabama",22,385,304,26,143,120,689,186.67886864881092
01055000500,"Census Tract 5, Etowah County, Alabama",51,160,253,40,74,98,413,122.80065146407001
01055000600,"Census Tract 6, Etowah County, Alabama",171,360,235,134,127,84,595,152.26621424334422
01055000700,"Census Tract 7, Etowah County, Alabama",42,152,218,38,57,75,370,94.2019108086455
01055000800,"Census Tract 8, Etowah County, Alabama",169,238,149,107,110,82,387,137.20058308913997
01055000900,"Census Tract 9, Etowah County, Alabama",0,138,110,12,91,63,248,110.67971810589327
01055001000,"Census Tract 10, Etowah County, Alabama",126,246,181,108,99,80,427,127.283148923964
01055001100,"Census Tract 11, Etowah County, Alabama",8,601,460,16,180,106,1061,208.89231675674432
01055001200,"Census Tract 12, Etowah County, Alabama",150,213,163,158,121,83,376,146.7310464761974
01055001300,"Census Tract 13, Etowah County, Alabama",191,217,245,130,101,125,462,160.70469812671936
01055001600,"Census Tract 16, Etowah County, Alabama",6,240,265,12,127,169,505,211.4000946073582
01055001700,"Census Tract 17, Etowah County, Alabama",125,142,126,136,56,70,268,89.64373932405988
01055010100,"Census Tract 101, Etowah County, Alabama",67,202,304,43,114,129,506,172.15400082484288
01055010200,"Census Tract 102, Etowah County, Alabama",87,830,452,118,402,199,1282,448.5588032800159
01055010300,"Census Tract 103, Etowah County, Alabama",0,283,235,12,94,98,518,135.79396157414365
01055010401,"Census Tract 104.01, Etowah County, Alabama",151,451,778,110,130,157,1229,203.83571816538927
01055010402,"Census Tract 104.02, Etowah County, Alabama",43,291,625,66,134,166,916,213.33541665649423
01055010501,"Census Tract 105.01, Etowah County, Alabama",71,853,901,73,236,235,1754,333.0480445821593
01055010502,"Census Tract 105.02, Etowah County, Alabama",27,656,390,33,214,165,1046,270.22398117117586
01055010601,"Census Tract 106.01, Etowah County, Alabama",25,589,685,37,183,185,1274,260.2191384199095
01055010602,"Census Tract 106.02, Etowah County, Alabama",0,348,388,12,124,106,736,163.1318485152424
01055010700,"Census Tract 107, Etowah County, Alabama",125,337,331,151,112,122,668,165.61400906928134
01055010800,"Census Tract 108, Etowah County, Alabama",0,473,131,12,162,88,604,184.35834670553976
01055010900,"Census Tract 109, Etowah County, Alabama",15,154,172,21,51,52,326,72.83543093852057
01055011001,"Census Tract 110.01, Etowah County, Alabama",0,493,673,17,135,155,1166,205.54804791094466
01055011002,"Census Tract 110.02, Etowah County, Alabama",83,587,430,77,171,129,1017,214.2008403344861
01055011100,"Census Tract 111, Etowah County, Alabama",5,571,674,5,168,239,1245,292.138665705175
01055011200,"Census Tract 112, Etowah County, Alabama",242,258,337,144,125,177,595,216.6887168266959
01057020000,"Census Tract 200, Fayette County, Alabama",0,129,170,12,40,57,299,69.63476143421474
01057020100,"Census Tract 201, Fayette County, Alabama",0,292,392,12,75,110,684,133.13526955694348
01057020200,"Census Tract 202, Fayette County, Alabama",28,500,308,48,120,96,808,153.67498169838836
01057020300,"Census Tract 203, Fayette County, Alabama",61,575,234,99,149,110,809,185.20529150107996
01057020400,"Census Tract 204, Fayette County, Alabama",37,417,463,49,97,144,880,173.62315513778685
01059972900,"Census Tract 9729, Franklin County, Alabama",354,532,451,230,181,181,983,255.9726547895302
01059973000,"Census Tract 9730, Franklin County, Alabama",941,531,461,350,219,254,992,335.37590849671955
01059973100,"Census Tract 9731, Franklin County, Alabama",119,283,173,107,99,76,456,124.80785231707178
01059973200,"Census Tract 9732, Franklin County, Alabama",983,652,515,218,141,175,1167,224.73539997072112
01059973300,"Census Tract 9733, Franklin County, Alabama",441,420,407,228,143,228,827,269.1337957224993
01059973400,"Census Tract 9734, Franklin County, Alabama",0,441,347,12,174,138,788,222.08106627986098
01059973500,"Census Tract 9735, Franklin County, Alabama",7,318,335,12,120,114,653,165.51737068960466
01059973600,"Census Tract 9736, Franklin County, Alabama",0,146,133,12,64,60,279,87.72684879784524
01059973700,"Census Tract 9737, Franklin County, Alabama",94,692,1047,94,237,263,1739,354.0310720826634
01061050100,"Census Tract 501, Geneva County, Alabama",177,472,495,94,121,104,967,159.55249919697278
01061050200,"Census Tract 502, Geneva County, Alabama",0,418,191,12,85,80,609,116.72617529928752
01061050300,"Census Tract 503, Geneva County, Alabama",36,479,860,44,134,176,1339,221.20578654275752
01061050400,"Census Tract 504, Geneva County, Alabama",88,682,372,73,176,130,1054,218.80585001320233
01061050500,"Census Tract 505, Geneva County, Alabama",151,440,546,93,160,158,986,224.86440358580546
01061050600,"Census Tract 506, Geneva County, Alabama",80,462,401,59,126,143,863,190.59118552545917
01063060000,"Census Tract 600, Greene County, Alabama",100,289,174,145,176,86,463,195.88772294352702
01063060100,"Census Tract 601, Greene County, Alabama",5,346,475,21,232,216,821,316.9858040985432
01063060200,"Census Tract 602, Greene County, Alabama",0,250,350,12,130,128,600,182.43903091169938
01065040000,"Census Tract 400, Hale County, Alabama",0,485,384,12,121,134,869,180.54639292990598
01065040100,"Census Tract 401, Hale County, Alabama",0,170,159,12,58,75,329,94.81033698917012
01065040200,"Census Tract 402, Hale County, Alabama",0,126,99,12,94,59,225,110.98198051936178
01065040300,"Census Tract 403, Hale County, Alabama",0,262,179,12,126,90,441,154.8418548067673
01065040400,"Census Tract 404, Hale County, Alabama",0,568,534,17,188,183,1102,262.36043909095747
01065040500,"Census Tract 405, Hale County, Alabama",0,200,288,12,115,162,488,198.66806487203723
01067030100,"Census Tract 301, Henry County, Alabama",9,190,102,14,71,46,292,84.59905436823747
01067030200,"Census Tract 302, Henry County, Alabama",85,277,253,77,84,91,530,123.84264209067892
01067030300,"Census Tract 303, Henry County, Alabama",46,158,113,50,80,92,271,121.91800523302537
01067030400,"Census Tract 304, Henry County, Alabama",4,183,199,7,59,68,382,90.02777349240623
01067030500,"Census Tract 305, Henry County, Alabama",46,936,784,76,174,120,1720,211.36697944570244
01067030600,"Census Tract 306, Henry County, Alabama",48,154,247,57,71,78,401,105.47511554864494
01069040100,"Census Tract 401, Houston County, Alabama",16,636,728,14,118,114,1364,164.07315441594946
01069040201,"Census Tract 402.01, Houston County, Alabama",165,1111,1085,62,125,135,2196,183.98369492974098
01069040202,"Census Tract 402.02, Houston County, Alabama",173,975,929,63,127,119,1904,174.04022523543227
01069040301,"Census Tract 403.01, Houston County, Alabama",64,433,351,40,85,79,784,116.04309544302927
01069040302,"Census Tract 403.02, Houston County, Alabama",243,470,586,118,72,103,1056,125.67020331009256
01069040400,"Census Tract 404, Houston County, Alabama",12,340,251,14,64,49,591,80.60397012554654
01069040500,"Census Tract 405, Houston County, Alabama",76,437,335,40,60,67,772,89.9388681271896
01069040600,"Census Tract 406, Houston County, Alabama",2,261,204,4,82,59,465,101.01980003939822
01069040700,"Census Tract 407, Houston County, Alabama",126,351,283,65,64,62,634,89.10667763978185
01069040800,"Census Tract 408, Houston County, Alabama",341,1290,1068,102,108,110,2358,154.1557653803451
01069040900,"Census Tract 409, Houston County, Alabama",92,605,509,36,77,76,1114,108.18964830333815
01069041000,"Census Tract 410, Houston County, Alabama",23,737,735,15,105,106,1472,149.20120642943877
01069041100,"Census Tract 411, Houston County, Alabama",84,372,325,61,83,74,697,111.19802156513397
01069041200,"Census Tract 412, Houston County, Alabama",37,196,303,54,59,70,499,91.54780172128658
01069041400,"Census Tract 414, Houston County, Alabama",15,522,381,12,124,89,903,152.63354808167173
01069041500,"Census Tract 415, Houston County, Alabama",6,356,417,7,70,74,773,101.86265262597475
01069041600,"Census Tract 416, Houston County, Alabama",77,632,628,52,85,90,1260,123.79418403139947
01069041700,"Census Tract 417, Houston County, Alabama",0,164,90,12,82,51,254,96.56603957913983
01069041800,"Census Tract 418, Houston County, Alabama",7,141,176,11,47,47,317,66.46803743153546
01069041900,"Census Tract 419, Houston County, Alabama",178,914,896,69,102,113,1810,152.22680447279973
01069042000,"Census Tract 420, Houston County, Alabama",78,635,510,93,78,98,1145,125.25174649480941
01069042100,"Census Tract 421, Houston County, Alabama",23,1004,981,23,150,218,1985,264.6204829562519
01071950100,"Census Tract 9501, Jackson County, Alabama",0,737,487,17,165,163,1224,231.93533581582605
01071950200,"Census Tract 9502, Jackson County, Alabama",151,365,285,163,138,115,650,179.63574254585305
01071950300,"Census Tract 9503, Jackson County, Alabama",115,871,632,102,197,142,1503,242.84357104934855
01071950400,"Census Tract 9504, Jackson County, Alabama",43,181,197,41,57,55,378,79.20858539325141
01071950500,"Census Tract 9505, Jackson County, Alabama",51,306,388,52,91,99,694,134.46932735757994
01071950600,"Census Tract 9506, Jackson County, Alabama",93,927,636,114,289,221,1563,363.8158875035558
01071950700,"Census Tract 9507, Jackson County, Alabama",91,362,594,76,103,203,956,227.63567382991621
01071950800,"Census Tract 9508, Jackson County, Alabama",49,254,317,52,124,127,571,177.49647883831386
01071950900,"Census Tract 9509, Jackson County, Alabama",0,535,539,17,144,143,1074,202.94087809014724
01071951000,"Census Tract 9510, Jackson County, Alabama",0,453,367,12,127,108,820,166.71232707871366
01071951100,"Census Tract 9511, Jackson County, Alabama",113,732,817,108,175,204,1549,268.7768591229535
01073000100,"Census Tract 1, Jefferson County, Alabama",212,611,392,149,204,224,1003,302.9719458959856
01073000300,"Census Tract 3, Jefferson County, Alabama",163,224,209,165,121,95,433,153.83757668398187
01073000400,"Census Tract 4, Jefferson County, Alabama",0,276,399,12,111,179,675,210.62288574606512
01073000500,"Census Tract 5, Jefferson County, Alabama",16,499,395,27,264,177,894,317.8443015062564
01073000700,"Census Tract 7, Jefferson County, Alabama",0,483,279,12,181,119,762,216.61486560252507
01073000800,"Census Tract 8, Jefferson County, Alabama",55,244,73,88,164,85,317,184.7187050625897
01073001100,"Census Tract 11, Jefferson County, Alabama",0,377,709,12,267,299,1086,400.8615721168593
01073001200,"Census Tract 12, Jefferson County, Alabama",11,129,203,18,60,99,332,115.76268828944843
01073001400,"Census Tract 14, Jefferson County, Alabama",65,197,157,66,125,77,354,146.81280598094978
01073001500,"Census Tract 15, Jefferson County, Alabama",16,215,118,25,89,64,333,109.62207806824317
01073001600,"Census Tract 16, Jefferson County, Alabama",38,259,245,47,84,92,504,124.57929201917949
01073001902,"Census Tract 19.02, Jefferson County, Alabama",121,187,257,59,70,117,444,136.34148304899725
01073002000,"Census Tract 20, Jefferson County, Alabama",180,510,444,176,255,182,954,313.28740798187215
01073002100,"Census Tract 21, Jefferson County, Alabama",20,180,398,34,118,184,578,218.58636736997119
01073002200,"Census Tract 22, Jefferson County, Alabama",0,278,288,12,171,97,566,196.596032513375
01073002303,"Census Tract 23.03, Jefferson County, Alabama",135,449,495,136,177,232,944,291.8098696069069
01073002305,"Census Tract 23.05, Jefferson County, Alabama",84,306,296,135,124,105,602,162.48384535085327
01073002306,"Census Tract 23.06, Jefferson County, Alabama",70,255,295,66,89,117,550,147.00340132119393
01073002400,"Census Tract 24, Jefferson County, Alabama",53,536,347,51,152,147,883,211.45448682872635
01073002700,"Census Tract 27, Jefferson County, Alabama",65,122,36,50,94,31,158,98.97979591815695
01073002900,"Census Tract 29, Jefferson County, Alabama",30,190,151,43,129,126,341,180.3247071257846
01073003001,"Census Tract 30.01, Jefferson County, Alabama",105,202,264,77,92,189,466,210.20228352708256
01073003002,"Census Tract 30.02, Jefferson County, Alabama",98,211,292,132,94,142,503,170.29386365926402
01073003100,"Census Tract 31, Jefferson County, Alabama",72,363,482,105,197,167,845,258.25955935840983
01073003200,"Census Tract 32, Jefferson County, Alabama",12,233,126,21,79,75,359,108.93117092916977
01073003300,"Census Tract 33, Jefferson County, Alabama",0,191,115,12,77,68,306,102.7277956543408
01073003400,"Census Tract 34, Jefferson County, Alabama",31,385,118,41,108,64,503,125.53883861180172
01073003500,"Census Tract 35, Jefferson County, Alabama",14,347,238,24,210,124,585,243.87701818744628
01073003600,"Census Tract 36, Jefferson County, Alabama",21,412,426,34,126,180,838,219.71800108320664
01073003700,"Census Tract 37, Jefferson County, Alabama",0,518,563,12,235,202,1081,309.88546271162835
01073003802,"Census Tract 38.02, Jefferson County, Alabama",0,739,554,17,296,261,1293,394.63527465243146
01073003803,"Census Tract 38.03, Jefferson County, Alabama",92,586,369,93,237,161,955,286.5135249861689
01073003900,"Census Tract 39, Jefferson County, Alabama",153,168,159,81,65,77,327,100.7670581092849
01073004000,"Census Tract 40, Jefferson County, Alabama",90,147,178,110,72,96,325,120
01073004200,"Census Tract 42, Jefferson County, Alabama",89,112,24,62,57,32,136,65.36818798161687
01073004500,"Census Tract 45, Jefferson County, Alabama",95,274,342,61,148,187,616,238.4806071780261
01073004701,"Census Tract 47.01, Jefferson County, Alabama",84,234,62,131,191,67,296,202.41047403728888
01073004702,"Census Tract 47.02, Jefferson County, Alabama",52,254,243,49,75,77,497,107.48953437428223
01073004800,"Census Tract 48, Jefferson County, Alabama",32,48,72,36,31,25,120,39.824615503479755
01073004901,"Census Tract 49.01, Jefferson County, Alabama",26,43,25,27,40,19,68,44.28317965096906
01073004902,"Census Tract 49.02, Jefferson County, Alabama",101,133,213,70,62,87,346,106.83164325236227
01073005000,"Census Tract 50, Jefferson County, Alabama",271,303,259,155,132,109,562,171.18703221914913
01073005101,"Census Tract 51.01, Jefferson County, Alabama",75,249,316,83,93,118,565,150.2431362824938
01073005103,"Census Tract 51.03, Jefferson County, Alabama",27,156,344,32,81,117,500,142.30249470757707
01073005104,"Census Tract 51.04, Jefferson County, Alabama",240,329,206,181,125,107,535,164.54178800535746
01073005200,"Census Tract 52, Jefferson County, Alabama",0,407,381,12,159,124,788,201.63581031156147
01073005302,"Census Tract 53.02, Jefferson County, Alabama",0,498,398,12,232,141,896,271.48664792214
01073005500,"Census Tract 55, Jefferson County, Alabama",81,244,290,80,101,125,534,160.70469812671936
01073005600,"Census Tract 56, Jefferson County, Alabama",91,161,369,82,77,241,530,253.00197627686626
01073005701,"Census Tract 57.01, Jefferson County, Alabama",0,301,172,12,78,147,473,166.41213898030395
01073005702,"Census Tract 57.02, Jefferson County, Alabama",0,87,277,12,70,156,364,170.985379491932
01073005800,"Census Tract 58, Jefferson County, Alabama",141,393,361,114,311,179,754,358.83422356291493
01073005903,"Census Tract 59.03, Jefferson County, Alabama",208,701,769,156,235,254,1470,346.0361252817399
01073005905,"Census Tract 59.05, Jefferson County, Alabama",309,998,868,239,354,379,1866,518.6106439324207
01073005907,"Census Tract 59.07, Jefferson County, Alabama",13,232,283,21,103,107,515,148.51935900750448
01073005908,"Census Tract 59.08, Jefferson County, Alabama",32,598,376,52,192,162,974,251.21305698549986
01073005909,"Census Tract 59.09, Jefferson County, Alabama",0,340,336,12,110,149,676,185.20529150107996
01073005910,"Census Tract 59.10, Jefferson County, Alabama",20,882,731,23,317,206,1613,378.05422891431857
01073010001,"Census Tract 100.01, Jefferson County, Alabama",0,775,617,12,233,236,1392,331.6398649137344
01073010002,"Census Tract 100.02, Jefferson County, Alabama",32,651,468,35,141,114,1119,181.3201588351389
01073010100,"Census Tract 101, Jefferson County, Alabama",8,125,218,14,113,121,343,165.55965692160635
01073010200,"Census Tract 102, Jefferson County, Alabama",346,237,159,231,145,98,396,175.0114281982751
01073010301,"Census Tract 103.01, Jefferson County, Alabama",80,360,240,98,160,137,600,210.63950246807934
01073010302,"Census Tract 103.02, Jefferson County, Alabama",21,502,608,35,171,210,1110,270.8154353060401
01073010401,"Census Tract 104.01, Jefferson County, Alabama",56,550,474,68,187,174,1024,255.43100829773977
01073010402,"Census Tract 104.02, Jefferson County, Alabama",32,431,373,38,119,211,804,242.24367896810023
01073010500,"Census Tract 105, Jefferson County, Alabama",86,142,149,79,68,87,291,110.42191811411355
01073010602,"Census Tract 106.02, Jefferson County, Alabama",33,345,870,49,152,340,1215,372.4298591681392
01073010603,"Census Tract 106.03, Jefferson County, Alabama",14,183,198,21,113,93,381,146.3488981851247
01073010701,"Census Tract 107.01, Jefferson County, Alabama",101,310,140,75,114,58,450,127.90621564255585
01073010702,"Census Tract 107.02, Jefferson County, Alabama",210,700,697,302,232,211,1397,313.6000637755037
01073010703,"Census Tract 107.03, Jefferson County, Alabama",0,418,375,12,82,75,793,111.12605455067681
01073010704,"Census Tract 107.04, Jefferson County, Alabama",102,344,480,100,126,163,824,206.0218435020908
01073010705,"Census Tract 107.05, Jefferson County, Alabama",55,569,542,44,124,121,1111,173.25414857947845
01073010706,"Census Tract 107.06, Jefferson County, Alabama",81,468,328,107,163,142,796,216.17816726024856
01073010801,"Census Tract 108.01, Jefferson County, Alabama",84,954,923,67,171,213,1877,273.1483113621609
01073010802,"Census Tract 108.02, Jefferson County, Alabama",46,336,568,50,75,101,904,125.80143083447024
01073010803,"Census Tract 108.03, Jefferson County, Alabama",50,866,706,58,296,202,1572,358.35736353534026
01073010804,"Census Tract 108.04, Jefferson County, Alabama",0,524,373,12,88,115,897,144.80676779764127
01073010805,"Census Tract 108.05, Jefferson County, Alabama",0,840,794,17,157,147,1634,215.07673049402624
01073010900,"Census Tract 109, Jefferson County, Alabama",148,692,448,123,256,157,1140,300.30817504690077
01073011001,"Census Tract 110.01, Jefferson County, Alabama",262,635,766,276,209,135,1401,248.80916381837707
01073011002,"Census Tract 110.02, Jefferson County, Alabama",9,335,145,14,133,59,480,145.49914089093448
01073011104,"Census Tract 111.04, Jefferson County, Alabama",347,1217,791,293,323,226,2008,394.21440866614705
01073011107,"Census Tract 111.07, Jefferson County, Alabama",134,1847,1575,199,323,315,3422,451.16959117387336
01073011108,"Census Tract 111.08, Jefferson County, Alabama",59,520,700,92,135,169,1220,216.3007165961315
01073011109,"Census Tract 111.09, Jefferson County, Alabama",21,353,639,22,120,161,992,200.80089641234176
01073011110,"Census Tract 111.10, Jefferson County, Alabama",14,657,579,24,206,186,1236,277.5463925184401
01073011111,"Census Tract 111.11, Jefferson County, Alabama",114,1205,1024,103,379,299,2229,482.7442387020274
01073011205,"Census Tract 112.05, Jefferson County, Alabama",64,179,266,53,66,107,445,125.7179382586272
01073011206,"Census Tract 112.06, Jefferson County, Alabama",47,520,357,83,203,159,877,257.8565492672234
01073011207,"Census Tract 112.07, Jefferson County, Alabama",221,959,847,258,210,238,1806,317.40195336512977
01073011208,"Census Tract 112.08, Jefferson County, Alabama",56,399,655,45,148,144,1054,206.49455198624491
01073011209,"Census Tract 112.09, Jefferson County, Alabama",59,759,488,95,239,242,1247,340.1249770305027
01073011210,"Census Tract 112.10, Jefferson County, Alabama",214,593,741,139,202,212,1334,292.8275943281302
01073011301,"Census Tract 113.01, Jefferson County, Alabama",97,390,508,82,126,191,898,228.81652038259824
01073011302,"Census Tract 113.02, Jefferson County, Alabama",10,870,984,14,102,130,1854,165.23922052587878
01073011400,"Census Tract 114, Jefferson County, Alabama",0,784,747,17,220,270,1531,348.28149534536
01073011500,"Census Tract 115, Jefferson County, Alabama",17,753,587,26,187,138,1340,232.4069706355642
01073011600,"Census Tract 116, Jefferson County, Alabama",0,505,328,12,107,92,833,141.1134295522577
01073011703,"Census Tract 117.03, Jefferson County, Alabama",158,989,1159,160,220,287,2148,361.61996626292637
01073011704,"Census Tract 117.04, Jefferson County, Alabama",13,446,407,21,98,99,853,139.30183056945089
01073011705,"Census Tract 117.05, Jefferson County, Alabama",503,1287,716,291,235,163,2003,285.99650347512994
01073011706,"Census Tract 117.06, Jefferson County, Alabama",60,348,291,45,102,78,639,128.40560735419618
01073011802,"Census Tract 118.02, Jefferson County, Alabama",170,908,1103,173,299,273,2011,404.88269906233336
01073011803,"Census Tract 118.03, Jefferson County, Alabama",7,842,696,12,281,205,1538,347.8304184512907
01073011804,"Census Tract 118.04, Jefferson County, Alabama",9,519,284,15,219,155,803,268.30206857197356
01073011901,"Census Tract 119.01, Jefferson County, Alabama",435,384,278,258,200,196,662,280.0285699709942
01073011904,"Census Tract 119.04, Jefferson County, Alabama",20,158,302,25,65,98,460,117.5967686630887
01073012001,"Census Tract 120.01, Jefferson County, Alabama",126,335,397,113,140,128,732,189.69449122207
01073012002,"Census Tract 120.02, Jefferson County, Alabama",50,1042,750,52,273,174,1792,323.736003558455
01073012103,"Census Tract 121.03, Jefferson County, Alabama",21,451,446,37,142,127,897,190.50721771103582
01073012104,"Census Tract 121.04, Jefferson County, Alabama",0,200,302,12,84,103,502,132.90974381135493
01073012200,"Census Tract 122, Jefferson County, Alabama",14,234,292,19,58,85,526,102.90286682109493
01073012302,"Census Tract 123.02, Jefferson County, Alabama",35,464,439,51,106,153,903,186.1316738225926
01073012304,"Census Tract 123.04, Jefferson County, Alabama",0,192,342,12,75,109,534,132.31024147812596
01073012305,"Census Tract 123.05, Jefferson County, Alabama",36,705,600,47,214,261,1305,337.51592555018794
01073012401,"Census Tract 124.01, Jefferson County, Alabama",56,319,406,62,140,124,725,187.01871564097536
01073012402,"Census Tract 124.02, Jefferson County, Alabama",15,252,354,23,107,184,606,212.8497122384712
01073012403,"Census Tract 124.03, Jefferson County, Alabama",24,416,425,29,158,132,841,205.8834621818858
01073012500,"Census Tract 125, Jefferson County, Alabama",8,516,562,12,163,164,1078,231.22499864850255
01073012602,"Census Tract 126.02, Jefferson County, Alabama",0,373,344,12,99,148,717,178.05897899291685
01073012701,"Census Tract 127.01, Jefferson County, Alabama",177,366,500,141,142,204,866,248.55582873873627
01073012703,"Census Tract 127.03, Jefferson County, Alabama",44,882,926,55,265,223,1808,346.3437598687177
01073012704,"Census Tract 127.04, Jefferson County, Alabama",0,381,243,12,87,76,624,115.52056094046635
01073012802,"Census Tract 128.02, Jefferson County, Alabama",9,244,289,15,92,69,533,115
01073012803,"Census Tract 128.03, Jefferson County, Alabama",35,303,365,44,127,157,668,201.9356333092305
01073012905,"Census Tract 129.05, Jefferson County, Alabama",85,701,579,77,139,117,1280,181.6865432551349
01073012906,"Census Tract 129.06, Jefferson County, Alabama",162,773,642,148,213,193,1415,287.43347056318964
01073012907,"Census Tract 129.07, Jefferson County, Alabama",18,634,598,29,168,147,1232,223.23306206742762
01073012908,"Census Tract 129.08, Jefferson County, Alabama",618,658,1005,361,277,412,1663,496.4604717396945
01073012910,"Census Tract 129.10, Jefferson County, Alabama",59,195,303,57,59,78,498,97.8008179924892
01073012911,"Census Tract 129.11, Jefferson County, Alabama",53,703,745,54,146,146,1448,206.47518010647187
01073012912,"Census Tract 129.12, Jefferson County, Alabama",323,630,434,274,178,203,1064,269.98703672583986
01073012913,"Census Tract 129.13, Jefferson County, Alabama",544,679,674,322,238,204,1353,313.4645115479582
01073012914,"Census Tract 129.14, Jefferson County, Alabama",7,77,123,13,54,70,200,88.40814442120137
01073012915,"Census Tract 129.15, Jefferson County, Alabama",356,707,859,289,220,209,1566,303.4485129309419
01073013002,"Census Tract 130.02, Jefferson County, Alabama",45,296,275,74,97,140,571,170.3202865192517
01073013100,"Census Tract 131, Jefferson County, Alabama",21,665,457,33,274,201,1122,339.8190695061123
01073013200,"Census Tract 132, Jefferson County, Alabama",59,321,381,74,95,106,702,142.3411395205195
01073013300,"Census Tract 133, Jefferson County, Alabama",288,317,307,161,114,120,624,165.51737068960466
01073013400,"Census Tract 134, Jefferson County, Alabama",81,373,634,89,130,238,1007,271.189970316013
01073013601,"Census Tract 136.01, Jefferson County, Alabama",193,315,465,105,103,150,780,181.95878654244757
01073013801,"Census Tract 138.01, Jefferson County, Alabama",80,161,159,47,74,65,320,98.49365461794989
01073013901,"Census Tract 139.01, Jefferson County, Alabama",0,119,174,12,64,86,293,107.20074626605917
01073013902,"Census Tract 139.02, Jefferson County, Alabama",0,232,284,12,83,90,516,122.42957159118053
01073014001,"Census Tract 140.01, Jefferson County, Alabama",47,396,386,55,88,80,782,118.92854997854805
01073014002,"Census Tract 140.02, Jefferson County, Alabama",9,349,519,17,121,208,868,240.63457773146402
01073014102,"Census Tract 141.02, Jefferson County, Alabama",95,487,350,118,157,90,837,180.96684779262748
01073014104,"Census Tract 141.04, Jefferson County, Alabama",41,388,413,56,141,188,801,235
01073014105,"Census Tract 141.05, Jefferson County, Alabama",4,390,489,9,172,151,879,228.87769659798658
01073014203,"Census Tract 142.03, Jefferson County, Alabama",41,1356,1203,60,379,318,2559,494.73730403113933
01073014204,"Census Tract 142.04, Jefferson County, Alabama",106,935,1379,85,269,204,2314,337.6047985440965
01073014301,"Census Tract 143.01, Jefferson County, Alabama",18,190,94,29,136,73,284,154.35349040433132
01073014302,"Census Tract 143.02, Jefferson County, Alabama",282,1137,802,178,222,191,1939,292.85662020859286
01073014404,"Census Tract 144.04, Jefferson County, Alabama",191,889,772,164,263,250,1661,362.86223281019477
01073014405,"Census Tract 144.05, Jefferson County, Alabama",80,444,643,53,116,136,1087,178.75122377203465
01073014406,"Census Tract 144.06, Jefferson County, Alabama",0,844,598,17,160,185,1442,244.59149617270018
01073014408,"Census Tract 144.08, Jefferson County, Alabama",76,453,377,83,195,168,830,257.38881094561975
01073014409,"Census Tract 144.09, Jefferson County, Alabama",27,288,221,42,97,80,509,125.73384588089239
01073014410,"Census Tract 144.10, Jefferson County, Alabama",61,457,588,74,134,137,1045,191.637678967368
01073014412,"Census Tract 144.12, Jefferson County, Alabama",30,687,488,30,143,97,1175,172.7946758439044
01073014413,"Census Tract 144.13, Jefferson County, Alabama",199,1219,1448,174,234,245,2667,338.7934473982636
01075030000,"Census Tract 300, Lamar County, Alabama",23,621,517,29,144,119,1138,186.80738743422327
01075030100,"Census Tract 301, Lamar County, Alabama",11,638,606,20,156,119,1244,196.2065238466856
01075030200,"Census Tract 302, Lamar County, Alabama",53,335,333,46,88,91,668,126.58988901172162
01077010100,"Census Tract 101, Lauderdale County, Alabama",39,83,36,37,55,31,119,63.13477647065839
01077010200,"Census Tract 102, Lauderdale County, Alabama",0,166,311,12,76,92,477,119.33147112141039
01077010300,"Census Tract 103, Lauderdale County, Alabama",32,132,165,33,77,89,297,117.6860229593982
01077010400,"Census Tract 104, Lauderdale County, Alabama",29,76,269,32,43,79,345,89.94442728707543
01077010600,"Census Tract 106, Lauderdale County, Alabama",20,213,234,29,105,132,447,168.66831356244717
01077010700,"Census Tract 107, Lauderdale County, Alabama",232,268,174,127,131,83,442,155.08062419270823
01077010800,"Census Tract 108, Lauderdale County, Alabama",142,497,452,145,163,175,949,239.15267090291925
01077010900,"Census Tract 109, Lauderdale County, Alabama",174,692,540,124,210,187,1232,281.19210515233175
01077011000,"Census Tract 110, Lauderdale County, Alabama",123,390,495,123,111,170,885,203.0295544988463
01077011101,"Census Tract 111.01, Lauderdale County, Alabama",20,583,649,31,139,165,1232,215.74522010927612
01077011102,"Census Tract 111.02, Lauderdale County, Alabama",78,596,319,121,193,205,915,281.55638866841576
01077011200,"Census Tract 112, Lauderdale County, Alabama",24,591,168,28,103,70,759,124.53513560437472
01077011300,"Census Tract 113, Lauderdale County, Alabama",23,204,355,25,78,135,559,155.9134375222354
01077011400,"Census Tract 114, Lauderdale County, Alabama",213,635,704,164,207,214,1339,297.73310195542587
01077011501,"Census Tract 115.01, Lauderdale County, Alabama",17,544,624,28,157,224,1168,273.5415873317986
01077011502,"Census Tract 115.02, Lauderdale County, Alabama",35,572,469,40,189,189,1041,267.28636328851496
01077011602,"Census Tract 116.02, Lauderdale County, Alabama",0,490,451,12,99,107,941,145.7737973711325
01077011603,"Census Tract 116.03, Lauderdale County, Alabama",115,508,572,99,135,173,1080,219.44019686465833
01077011604,"Census Tract 116.04, Lauderdale County, Alabama",0,837,683,17,199,174,1520,264.3425807545958
01077011700,"Census Tract 117, Lauderdale County, Alabama",4,485,461,6,117,145,946,186.31693428134759
01077011801,"Census Tract 118.01, Lauderdale County, Alabama",0,548,358,12,226,163,906,278.6485241303101
01077011802,"Census Tract 118.02, Lauderdale County, Alabama",85,400,310,61,125,109,710,165.8493292117879
01079979100,"Census Tract 9791, Lawrence County, Alabama",0,144,58,12,71,42,202,82.49242389456137
01079979200,"Census Tract 9792, Lawrence County, Alabama",48,401,461,38,175,134,862,220.41097976280582
01079979300,"Census Tract 9793, Lawrence County, Alabama",7,622,661,14,283,208,1283,351.2164574731657
01079979400,"Census Tract 9794, Lawrence County, Alabama",24,364,529,35,151,168,893,225.88713996153035
01079979500,"Census Tract 9795, Lawrence County, Alabama",172,992,610,138,215,222,1602,309.0453041222274
01079979600,"Census Tract 9796, Lawrence County, Alabama",0,376,247,12,132,151,623,200.5617112013158
01079979700,"Census Tract 9797, Lawrence County, Alabama",8,166,326,15,61,86,492,105.43718509140881
01079979800,"Census Tract 9798, Lawrence County, Alabama",41,305,505,65,117,161,810,199.0226117806718
01079979900,"Census Tract 9799, Lawrence County, Alabama",0,170,246,12,73,66,416,98.41239759298622
01081040200,"Census Tract 402, Lee County, Alabama",143,391,344,105,126,169,735,210.80085388821365
01081040300,"Census Tract 403, Lee County, Alabama",10,91,93,15,56,54,184,77.79460135510689
01081040400,"Census Tract 404, Lee County, Alabama",105,579,542,66,204,162,1121,260.4995201531089
01081040500,"Census Tract 405, Lee County, Alabama",85,1101,1755,83,262,600,2856,654.7090957058715
01081040602,"Census Tract 406.02, Lee County, Alabama",39,848,810,65,292,287,1658,409.4300917128588
01081040603,"Census Tract 406.03, Lee County, Alabama",21,48,40,25,49,35,88,60.21627686929839
01081040604,"Census Tract 406.04, Lee County, Alabama",165,217,290,135,122,196,507,230.8679276123039
01081040700,"Census Tract 407, Lee County, Alabama",75,0,26,55,17,33,26,37.12142238654117
01081040800,"Census Tract 408, Lee County, Alabama",69,0,0,88,12,12,0,16.97056274847714
01081040901,"Census Tract 409.01, Lee County, Alabama",111,467,379,107,241,128,846,272.88275870783775
01081040902,"Census Tract 409.02, Lee County, Alabama",187,407,440,154,232,231,847,327.3912033027155
01081041000,"Census Tract 410, Lee County, Alabama",189,1254,1173,113,258,266,2427,370.56713291925934
01081041100,"Census Tract 411, Lee County, Alabama",492,1133,1308,192,358,308,2441,472.25840384264205
01081041200,"Census Tract 412, Lee County, Alabama",32,537,507,35,167,173,1044,240.45373775427157
01081041300,"Census Tract 413, Lee County, Alabama",36,494,259,57,155,162,753,224.20749318432692
01081041400,"Census Tract 414, Lee County, Alabama",0,494,325,12,201,184,819,272.5013761433142
01081041600,"Census Tract 416, Lee County, Alabama",81,643,384,78,208,136,1027,248.51559307214507
01081041700,"Census Tract 417, Lee County, Alabama",217,1217,1212,172,312,304,2429,435.6145084819834
01081041800,"Census Tract 418, Lee County, Alabama",273,1535,947,315,374,304,2482,481.9668038361148
01081041900,"Census Tract 419, Lee County, Alabama",172,916,871,117,271,262,1787,376.9416400452463
01081042002,"Census Tract 420.02, Lee County, Alabama",215,815,696,209,239,207,1511,316.1803282938393
01081042003,"Census Tract 420.03, Lee County, Alabama",98,361,412,133,113,115,773,161.22654868228122
01081042004,"Census Tract 420.04, Lee County, Alabama",212,1433,1690,133,242,275,3123,366.31816771762766
01081042005,"Census Tract 420.05, Lee County, Alabama",107,723,490,78,185,142,1213,233.21449354617735
01081042006,"Census Tract 420.06, Lee County, Alabama",5,162,209,13,73,78,371,106.83164325236227
01081042101,"Census Tract 421.01, Lee County, Alabama",35,465,478,50,98,124,943,158.05062480104277
01081042102,"Census Tract 421.02, Lee County, Alabama",46,1389,988,62,559,281,2377,625.6532586025586
01083020101,"Census Tract 201.01, Limestone County, Alabama",126,536,635,101,117,157,1171,195.80091930325557
01083020102,"Census Tract 201.02, Limestone County, Alabama",15,715,640,17,161,140,1355,213.3565091577944
01083020201,"Census Tract 202.01, Limestone County, Alabama",225,361,682,157,118,184,1043,218.58636736997119
01083020202,"Census Tract 202.02, Limestone County, Alabama",40,823,378,57,158,153,1201,219.93862780330335
01083020300,"Census Tract 203, Limestone County, Alabama",0,460,318,12,109,108,778,153.44380078712857
01083020401,"Census Tract 204.01, Limestone County, Alabama",432,697,771,333,162,237,1468,287.07664481806944
01083020402,"Census Tract 204.02, Limestone County, Alabama",193,691,680,183,213,182,1371,280.1660222082614
01083020500,"Census Tract 205, Limestone County, Alabama",14,169,178,26,99,94,347,136.517398158623
01083020600,"Census Tract 206, Limestone County, Alabama",521,657,563,259,138,172,1220,220.51757299589528
01083020700,"Census Tract 207, Limestone County, Alabama",175,358,358,135,145,120,716,188.2153022471871
01083020801,"Census Tract 208.01, Limestone County, Alabama",269,588,935,188,174,217,1523,278.14564530116235
01083020802,"Census Tract 208.02, Limestone County, Alabama",171,1061,1338,140,254,294,2399,388.52541744395563
01083020900,"Census Tract 209, Limestone County, Alabama",132,463,475,108,152,128,938,198.71587757398754
01083021000,"Census Tract 210, Limestone County, Alabama",94,263,224,81,114,102,487,152.97058540778355
01083021100,"Census Tract 211, Limestone County, Alabama",181,595,458,214,230,177,1053,290.2223285689783
01083021200,"Census Tract 212, Limestone County, Alabama",295,2367,2146,200,377,328,4513,499.71291758368625
01085780800,"Census Tract 7808, Lowndes County, Alabama",12,393,326,19,115,116,719,163.3431969810803
01085781000,"Census Tract 7810, Lowndes County, Alabama",12,391,202,22,109,61,593,124.90796611905904
01085781100,"Census Tract 7811, Lowndes County, Alabama",0,154,153,12,59,71,307,92.31467922275417
01085781200,"Census Tract 7812, Lowndes County, Alabama",0,260,392,12,112,115,652,160.52725625263767
01087231400,"Census Tract 2314, Macon County, Alabama",0,232,57,12,81,55,289,97.9081201943945
01087231500,"Census Tract 2315, Macon County, Alabama",6,190,155,9,60,77,345,97.6165969494942
01087231601,"Census Tract 2316.01, Macon County, Alabama",11,20,77,12,22,55,97,59.23681287847955
01087231602,"Census Tract 2316.02, Macon County, Alabama",0,217,211,12,79,73,428,107.56393447619885
01087231603,"Census Tract 2316.03, Macon County, Alabama",0,95,86,12,63,44,181,76.84399781375251
01087231700,"Census Tract 2317, Macon County, Alabama",18,42,41,23,50,40,83,64.03124237432849
01087231800,"Census Tract 2318, Macon County, Alabama",10,52,73,12,41,41,125,57.982756057296896
01087231900,"Census Tract 2319, Macon County, Alabama",0,176,150,12,84,62,326,104.4030650891055
01087232000,"Census Tract 2320, Macon County, Alabama",83,145,169,124,115,91,314,146.64924138910504
01087232100,"Census Tract 2321, Macon County, Alabama",0,118,91,12,59,56,209,81.34494452638098
01087232200,"Census Tract 2322, Macon County, Alabama",10,235,390,13,81,164,625,182.91254740995763
01087232300,"Census Tract 2323, Macon County, Alabama",0,155,71,12,83,69,226,107.93516572461452
01089000201,"Census Tract 2.01, Madison County, Alabama",21,180,161,27,66,50,341,82.80096617793781
01089000202,"Census Tract 2.02, Madison County, Alabama",65,153,83,51,88,65,236,109.40292500660117
01089000301,"Census Tract 3.01, Madison County, Alabama",114,553,483,85,207,120,1036,239.26763257908496
01089000302,"Census Tract 3.02, Madison County, Alabama",205,624,527,146,280,177,1151,331.25367922485026
01089000403,"Census Tract 4.03, Madison County, Alabama",30,532,401,36,166,163,933,232.64780248263682
01089000501,"Census Tract 5.01, Madison County, Alabama",109,393,252,78,164,98,645,191.049731745428
01089000502,"Census Tract 5.02, Madison County, Alabama",33,390,225,28,115,88,615,144.80676779764127
01089000503,"Census Tract 5.03, Madison County, Alabama",17,133,117,19,65,52,250,83.24061508662703
01089000601,"Census Tract 6.01, Madison County, Alabama",8,130,91,17,64,38,221,74.43117626371358
01089000602,"Census Tract 6.02, Madison County, Alabama",109,237,248,89,104,111,485,152.10851389715174
01089000701,"Census Tract 7.01, Madison County, Alabama",193,287,197,168,92,103,484,138.10503249338888
01089000702,"Census Tract 7.02, Madison County, Alabama",5,146,242,10,87,139,388,163.98170629676957
01089000901,"Census Tract 9.01, Madison County, Alabama",172,560,265,204,227,148,825,270.9852394504173
01089000902,"Census Tract 9.02, Madison County, Alabama",20,179,97,21,86,55,276,102.08329931972223
01089001000,"Census Tract 10, Madison County, Alabama",72,101,215,60,45,62,316,76.60939890117922
01089001200,"Census Tract 12, Madison County, Alabama",84,458,513,37,133,162,971,209.60200380721554
01089001301,"Census Tract 13.01, Madison County, Alabama",74,357,114,69,165,83,471,184.69975636150687
01089001302,"Census Tract 13.02, Madison County, Alabama",109,215,181,78,76,51,396,91.52595260361949
01089001401,"Census Tract 14.01, Madison County, Alabama",167,193,134,103,74,53,327,91.02197536858887
01089001402,"Census Tract 14.02, Madison County, Alabama",120,242,516,106,111,163,758,197.20547659738054
01089001500,"Census Tract 15, Madison County, Alabama",366,294,199,253,109,61,493,124.90796611905904
01089001700,"Census Tract 17, Madison County, Alabama",6,258,185,10,56,65,443,85.7962703152066
01089001801,"Census Tract 18.01, Madison County, Alabama",43,395,440,38,94,113,835,146.98639392814562
01089001901,"Census Tract 19.01, Madison County, Alabama",48,507,356,52,173,108,863,203.94361965994426
01089001902,"Census Tract 19.02, Madison County, Alabama",22,134,117,23,55,38,251,66.85057965343307
01089001903,"Census Tract 19.03, Madison County, Alabama",56,306,180,52,56,49,486,74.41102068914255
01089002000,"Census Tract 20, Madison County, Alabama",75,206,288,61,85,74,494,112.69871339105873
01089002100,"Census Tract 21, Madison County, Alabama",367,311,627,232,127,142,938,190.50721771103582
01089002200,"Census Tract 22, Madison County, Alabama",215,138,133,103,60,67,271,89.9388681271896
01089002300,"Census Tract 23, Madison County, Alabama",632,605,337,339,187,115,942,219.5313189501671
01089002400,"Census Tract 24, Madison County, Alabama",226,652,721,172,232,286,1373,368.26620806150544
01089002501,"Census Tract 25.01, Madison County, Alabama",668,464,502,221,147,163,966,219.49487465542333
01089002502,"Census Tract 25.02, Madison County, Alabama",231,341,338,113,139,148,679,203.03940504246953
01089002600,"Census Tract 26, Madison County, Alabama",35,355,281,39,171,173,636,243.24884377936928
01089002701,"Census Tract 27.01, Madison County, Alabama",8,144,186,15,38,98,330,105.1094667477673
01089002721,"Census Tract 27.21, Madison County, Alabama",22,304,518,23,87,175,822,195.4328529188478
01089002722,"Census Tract 27.22, Madison County, Alabama",46,297,319,47,131,86,616,156.70673246545599
01089002801,"Census Tract 28.01, Madison County, Alabama",104,324,501,87,189,180,825,261
01089002802,"Census Tract 28.02, Madison County, Alabama",70,732,892,66,200,190,1624,275.86228448267445
01089002911,"Census Tract 29.11, Madison County, Alabama",62,435,415,68,103,109,850,149.96666296213968
01089002912,"Census Tract 29.12, Madison County, Alabama",27,250,215,25,67,65,465,93.34880824091971
01089002921,"Census Tract 29.21, Madison County, Alabama",72,660,731,74,306,190,1391,360.1888393606887
01089002922,"Census Tract 29.22, Madison County, Alabama",99,308,295,85,84,85,603,119.50313803411188
01089003000,"Census Tract 30, Madison County, Alabama",129,423,355,111,200,172,778,263.78779350076076
01089003100,"Census Tract 31, Madison County, Alabama",127,209,252,58,78,54,461,94.86832980505137
01089010100,"Census Tract 101, Madison County, Alabama",70,1102,1072,57,227,206,2174,306.5371103145588
01089010200,"Census Tract 102, Madison County, Alabama",18,529,890,31,175,189,1419,257.57717290163737
01089010301,"Census Tract 103.01, Madison County, Alabama",25,794,939,29,201,214,1733,293.59325605333646
01089010302,"Census Tract 103.02, Madison County, Alabama",168,655,509,183,164,140,1164,215.62931155109686
01089010401,"Census Tract 104.01, Madison County, Alabama",194,707,700,183,265,195,1407,329.013677527242
01089010402,"Census Tract 104.02, Madison County, Alabama",73,653,520,72,142,194,1173,240.41630560342617
01089010501,"Census Tract 105.01, Madison County, Alabama",122,1967,1493,71,352,261,3460,438.20657229210974
01089010502,"Census Tract 105.02, Madison County, Alabama",100,440,494,78,160,118,934,198.80643852752857
01089010612,"Census Tract 106.12, Madison County, Alabama",133,670,661,93,192,143,1331,239.40133667128927
01089010621,"Census Tract 106.21, Madison County, Alabama",92,1109,719,100,198,152,1828,249.61570463414355
01089010622,"Census Tract 106.22, Madison County, Alabama",334,843,586,290,321,243,1429,402.6040238248992
01089010623,"Census Tract 106.23, Madison County, Alabama",146,892,1044,113,244,283,1936,373.6642878306676
01089010624,"Census Tract 106.24, Madison County, Alabama",186,1044,1150,152,302,273,2194,407.1031810241723
01089010701,"Census Tract 107.01, Madison County, Alabama",81,1270,1040,55,270,316,2310,415.63926667243555
01089010702,"Census Tract 107.02, Madison County, Alabama",204,840,980,112,191,250,1820,314.61246002026047
01089010800,"Census Tract 108, Madison County, Alabama",92,1195,1151,92,263,288,2346,390.0166663105565
01089010901,"Census Tract 109.01, Madison County, Alabama",148,2542,2201,130,462,412,4743,619.0218089857578
01089010902,"Census Tract 109.02, Madison County, Alabama",17,286,430,22,75,128,716,148.35430563350698
01089011011,"Census Tract 110.11, Madison County, Alabama",161,1367,1530,79,202,225,2897,302.3722870899382
01089011012,"Census Tract 110.12, Madison County, Alabama",19,554,431,31,151,131,985,199.90497742677644
01089011013,"Census Tract 110.13, Madison County, Alabama",97,535,724,62,141,221,1259,262.14881269996243
01089011014,"Census Tract 110.14, Madison County, Alabama",203,1564,1041,161,241,260,2605,354.5151618760473
01089011021,"Census Tract 110.21, Madison County, Alabama",131,520,412,109,164,168,932,234.77648945326703
01089011022,"Census Tract 110.22, Madison County, Alabama",471,995,809,379,341,266,1804,432.4777450921608
01089011100,"Census Tract 111, Madison County, Alabama",55,177,145,32,54,51,322,74.27651041883968
01089011200,"Census Tract 112, Madison County, Alabama",317,873,1764,137,259,419,2637,492.5870481447924
01089011300,"Census Tract 113, Madison County, Alabama",153,775,751,108,125,164,1526,206.20620747203515
01089011400,"Census Tract 114, Madison County, Alabama",0,547,496,12,132,107,1043,169.92056967889437
01091972900,"Census Tract 9729, Marengo County, Alabama",61,610,658,94,226,222,1268,316.79646462673793
01091973000,"Census Tract 9730, Marengo County, Alabama",18,458,177,23,205,81,635,220.42232191862965
01091973100,"Census Tract 9731, Marengo County, Alabama",3,110,96,5,54,40,206,67.20119046564577
01091973200,"Census Tract 9732, Marengo County, Alabama",0,572,353,12,184,160,925,243.83601046605074
01091973300,"Census Tract 9733, Marengo County, Alabama",0,331,272,12,102,128,603,163.67040050051813
01091973400,"Census Tract 9734, Marengo County, Alabama",0,313,453,12,109,176,766,207.01932276963907
01093964000,"Census Tract 9640, Marion County, Alabama",78,548,411,96,135,102,959,169.2010638264429
01093964100,"Census Tract 9641, Marion County, Alabama",0,290,258,12,95,71,548,118.6001686339442
01093964200,"Census Tract 9642, Marion County, Alabama",0,128,139,12,44,73,267,85.23496934944014
01093964300,"Census Tract 9643, Marion County, Alabama",106,755,530,105,160,177,1285,238.5979882563975
01093964400,"Census Tract 9644, Marion County, Alabama",28,356,440,49,137,161,796,211.4000946073582
01093964500,"Census Tract 9645, Marion County, Alabama",21,190,147,29,50,53,337,72.86288492778748
01093964600,"Census Tract 9646, Marion County, Alabama",117,368,399,102,95,117,767,150.71164520368026
01093964700,"Census Tract 9647, Marion County, Alabama",73,679,636,62,177,134,1315,222.00225224082752
01095030100,"Census Tract 301, Marshall County, Alabama",63,205,338,104,118,116,543,165.46903033498444
01095030201,"Census Tract 302.01, Marshall County, Alabama",34,363,599,39,156,153,962,218.50629281556172
01095030202,"Census Tract 302.02, Marshall County, Alabama",368,526,386,344,186,179,912,258.14143410154054
01095030300,"Census Tract 303, Marshall County, Alabama",152,864,509,214,181,142,1373,230.05434140654683
01095030401,"Census Tract 304.01, Marshall County, Alabama",54,494,472,31,81,76,966,111.07204868912791
01095030402,"Census Tract 304.02, Marshall County, Alabama",106,579,276,118,182,55,855,190.12890364171355
01095030500,"Census Tract 305, Marshall County, Alabama",111,1040,771,74,176,149,1811,230.6013876801265
01095030600,"Census Tract 306, Marshall County, Alabama",388,695,769,213,114,116,1464,162.64070831129578
01095030701,"Census Tract 307.01, Marshall County, Alabama",180,314,669,119,97,197,983,219.58597405116748
01095030702,"Census Tract 307.02, Marshall County, Alabama",123,363,391,80,111,109,754,155.56991997169632
01095030801,"Census Tract 308.01, Marshall County, Alabama",563,859,750,275,268,195,1609,331.4347597944428
01095030802,"Census Tract 308.02, Marshall County, Alabama",1956,1352,1448,343,250,259,2800,359.97361014385484
01095030902,"Census Tract 309.02, Marshall County, Alabama",494,705,695,137,132,142,1400,193.8762491900439
01095030903,"Census Tract 309.03, Marshall County, Alabama",689,726,590,339,311,313,1316,441.23689782247357
01095030904,"Census Tract 309.04, Marshall County, Alabama",609,880,761,229,183,295,1641,347.15126386058284
01095031000,"Census Tract 310, Marshall County, Alabama",553,748,808,219,176,144,1556,227.40272645683032
01095031100,"Census Tract 311, Marshall County, Alabama",599,891,636,192,249,218,1527,330.94561486745823
01095031200,"Census Tract 312, Marshall County, Alabama",233,716,699,284,266,308,1415,406.96437190496175
01097000200,"Census Tract 2, Mobile County, Alabama",27,0,24,28,12,34,24,36.05551275463989
01097000401,"Census Tract 4.01, Mobile County, Alabama",0,105,115,12,72,56,220,91.21403400793103
01097000402,"Census Tract 4.02, Mobile County, Alabama",0,196,145,12,63,52,341,81.68843247363729
01097000500,"Census Tract 5, Mobile County, Alabama",0,247,94,12,100,44,341,109.2520022699813
01097000600,"Census Tract 6, Mobile County, Alabama",0,212,198,12,112,79,410,137.05838172107534
01097000701,"Census Tract 7.01, Mobile County, Alabama",0,179,133,12,113,79,312,137.87675656179326
01097000702,"Census Tract 7.02, Mobile County, Alabama",0,279,301,12,152,138,580,205.2997808084558
01097000800,"Census Tract 8, Mobile County, Alabama",48,692,482,64,244,200,1174,315.49326458737596
01097000901,"Census Tract 9.01, Mobile County, Alabama",18,249,199,21,102,117,448,155.21919984331836
01097000902,"Census Tract 9.02, Mobile County, Alabama",11,150,269,17,73,113,419,134.52880732393342
01097000903,"Census Tract 9.03, Mobile County, Alabama",6,133,112,8,70,42,245,81.6333265278342
01097001001,"Census Tract 10.01, Mobile County, Alabama",0,82,186,12,41,94,268,102.55242561733974
01097001002,"Census Tract 10.02, Mobile County, Alabama",0,171,148,12,66,96,319,116.49892703368559
01097001100,"Census Tract 11, Mobile County, Alabama",12,280,252,19,121,102,532,158.25612152457168
01097001200,"Census Tract 12, Mobile County, Alabama",59,167,135,41,85,61,302,104.62313319720452
01097001302,"Census Tract 13.02, Mobile County, Alabama",0,384,213,12,185,123,597,222.15760171553887
01097001400,"Census Tract 14, Mobile County, Alabama",0,173,119,12,72,71,292,101.11874208078342
01097001501,"Census Tract 15.01, Mobile County, Alabama",0,197,170,12,81,69,367,106.4048871058092
01097001502,"Census Tract 15.02, Mobile County, Alabama",0,302,296,12,124,103,598,161.19863522995473
01097001800,"Census Tract 18, Mobile County, Alabama",41,278,396,66,94,124,674,155.60205654167942
01097001901,"Census Tract 19.01, Mobile County, Alabama",0,276,295,12,131,150,571,199.15069670980316
01097001902,"Census Tract 19.02, Mobile County, Alabama",0,232,506,12,112,111,738,157.68639763784319
01097002000,"Census Tract 20, Mobile County, Alabama",20,258,92,38,68,40,350,78.89233169326408
01097002100,"Census Tract 21, Mobile County, Alabama",14,563,483,26,220,146,1046,264.0378760708395
01097002200,"Census Tract 22, Mobile County, Alabama",43,339,406,65,137,174,745,221.46105752479374
01097002301,"Census Tract 23.01, Mobile County, Alabama",11,154,401,23,69,191,555,203.08126452235814
01097002302,"Census Tract 23.02, Mobile County, Alabama",0,170,218,12,83,118,388,144.26711336961034
01097002400,"Census Tract 24, Mobile County, Alabama",34,472,290,52,234,141,762,273.1977305908671
01097002501,"Census Tract 25.01, Mobile County, Alabama",18,402,301,29,94,128,703,158.80806024884254
01097002502,"Census Tract 25.02, Mobile County, Alabama",34,265,174,53,89,78,439,118.3427226321923
01097002600,"Census Tract 26, Mobile County, Alabama",0,299,248,12,160,133,547,208.0600874747485
01097002700,"Census Tract 27, Mobile County, Alabama",36,422,363,51,167,114,785,202.20039564748632
01097002800,"Census Tract 28, Mobile County, Alabama",17,648,305,29,402,163,953,433.78911927340914
01097002900,"Census Tract 29, Mobile County, Alabama",202,462,682,143,100,259,1144,277.6346520159182
01097003000,"Census Tract 30, Mobile County, Alabama",0,399,277,12,137,107,676,173.83325343558406
01097003100,"Census Tract 31, Mobile County, Alabama",24,446,467,27,147,134,913,198.90952717253137
01097003202,"Census Tract 32.02, Mobile County, Alabama",124,213,274,123,143,202,487,247.49343425634547
01097003203,"Census Tract 32.03, Mobile County, Alabama",71,215,307,77,142,149,522,205.8275977608445
01097003204,"Census Tract 32.04, Mobile County, Alabama",139,135,506,118,111,316,641,334.9283505467998
01097003205,"Census Tract 32.05, Mobile County, Alabama",74,301,462,69,159,225,763,275.5104353740526
01097003301,"Census Tract 33.01, Mobile County, Alabama",74,185,147,112,97,63,332,115.66330446602328
01097003302,"Census Tract 33.02, Mobile County, Alabama",91,374,351,58,127,112,725,169.33103672983285
01097003402,"Census Tract 34.02, Mobile County, Alabama",11,372,836,24,204,234,1208,310.43839968663673
01097003404,"Census Tract 34.04, Mobile County, Alabama",0,294,304,12,119,122,598,170.42593699317015
01097003405,"Census Tract 34.05, Mobile County, Alabama",58,152,245,64,62,75,397,97.30878685915265
01097003406,"Census Tract 34.06, Mobile County, Alabama",0,366,432,12,241,251,798,347.96838936891953
01097003407,"Census Tract 34.07, Mobile County, Alabama",2,596,593,4,221,310,1189,380.71117661555456
01097003408,"Census Tract 34.08, Mobile County, Alabama",25,481,297,42,179,126,778,218.89952032839176
01097003501,"Census Tract 35.01, Mobile County, Alabama",138,348,377,150,98,109,725,146.57762448614045
01097003502,"Census Tract 35.02, Mobile County, Alabama",0,236,239,12,108,96,475,144.49913494550754
01097003602,"Census Tract 36.02, Mobile County, Alabama",78,180,166,77,68,56,346,88.09086218218096
01097003605,"Census Tract 36.05, Mobile County, Alabama",0,0,16,12,12,26,16,28.635642126552707
01097003606,"Census Tract 36.06, Mobile County, Alabama",126,167,299,77,85,123,466,149.5125412799876
01097003607,"Census Tract 36.07, Mobile County, Alabama",46,178,277,55,92,147,455,173.4156855650607
01097003608,"Census Tract 36.08, Mobile County, Alabama",42,155,99,44,68,85,254,108.85311203635843
01097003703,"Census Tract 37.03, Mobile County, Alabama",42,425,404,54,199,133,829,239.35329536064467
01097003704,"Census Tract 37.04, Mobile County, Alabama",90,349,510,78,98,133,859,165.20593209688326
01097003705,"Census Tract 37.05, Mobile County, Alabama",53,437,409,50,143,107,846,178.60011198204776
01097003706,"Census Tract 37.06, Mobile County, Alabama",21,275,218,33,84,77,493,113.95174417269794
01097003707,"Census Tract 37.07, Mobile County, Alabama",0,449,525,12,175,269,974,320.9143187830671
01097003708,"Census Tract 37.08, Mobile County, Alabama",93,525,368,76,173,151,893,229.63013739489858
01097003709,"Census Tract 37.09, Mobile County, Alabama",106,1143,586,120,518,171,1729,545.4951878797832
01097003710,"Census Tract 37.10, Mobile County, Alabama",104,417,412,118,145,216,829,260.155722597063
01097003800,"Census Tract 38, Mobile County, Alabama",0,195,135,12,74,74,330,104.65180361560904
01097003901,"Census Tract 39.01, Mobile County, Alabama",0,231,235,12,104,116,466,155.79473675320358
01097003902,"Census Tract 39.02, Mobile County, Alabama",0,119,39,12,96,39,158,103.61949623502326
01097004000,"Census Tract 40, Mobile County, Alabama",8,346,505,18,124,236,851,266.5933232472261
01097004100,"Census Tract 41, Mobile County, Alabama",0,39,16,12,62,74,55,96.54014708917737
01097004800,"Census Tract 48, Mobile County, Alabama",0,128,140,12,68,128,268,144.9413674559475
01097004900,"Census Tract 49, Mobile County, Alabama",130,759,543,155,293,229,1302,371.8736344512743
01097005000,"Census Tract 50, Mobile County, Alabama",0,218,295,12,90,133,513,160.58953888718904
01097005100,"Census Tract 51, Mobile County, Alabama",32,356,302,42,158,153,658,219.93862780330335
01097005200,"Census Tract 52, Mobile County, Alabama",33,149,210,44,73,50,359,88.48163651289458
01097005300,"Census Tract 53, Mobile County, Alabama",15,299,369,23,117,136,668,179.4017837146554
01097005400,"Census Tract 54, Mobile County, Alabama",4,499,654,9,121,135,1153,181.289823211343
01097005500,"Census Tract 55, Mobile County, Alabama",61,378,432,75,108,136,810,173.6663467687393
01097005600,"Census Tract 56, Mobile County, Alabama",0,750,975,17,198,280,1725,342.9343960584881
01097005700,"Census Tract 57, Mobile County, Alabama",0,881,1236,17,221,257,2117,338.9542742022882
01097005800,"Census Tract 58, Mobile County, Alabama",2,410,435,7,132,163,845,209.74508337503408
01097005900,"Census Tract 59, Mobile County, Alabama",0,432,629,12,203,204,1061,287.7933286231632
01097006000,"Census Tract 60, Mobile County, Alabama",101,648,987,156,215,229,1635,314.1114451910341
01097006102,"Census Tract 61.02, Mobile County, Alabama",31,299,242,43,139,109,541,176.64087862100325
01097006103,"Census Tract 61.03, Mobile County, Alabama",0,1031,463,17,222,270,1494,349.5482799271082
01097006104,"Census Tract 61.04, Mobile County, Alabama",0,700,658,12,187,194,1358,269.45314991664134
01097006105,"Census Tract 61.05, Mobile County, Alabama",29,842,914,34,349,400,1756,530.849319487178
01097006200,"Census Tract 62, Mobile County, Alabama",259,648,414,207,246,159,1062,292.91124935720717
01097006301,"Census Tract 63.01, Mobile County, Alabama",178,1602,1513,130,453,416,3115,615.0325194654345
01097006302,"Census Tract 63.02, Mobile County, Alabama",186,946,959,138,284,243,1905,373.77132046212427
01097006402,"Census Tract 64.02, Mobile County, Alabama",121,517,409,119,163,151,926,222.19360926903366
01097006403,"Census Tract 64.03, Mobile County, Alabama",25,241,279,31,75,73,520,104.66135867644753
01097006404,"Census Tract 64.04, Mobile County, Alabama",230,1629,1807,202,389,330,3436,510.1186136576473
01097006405,"Census Tract 64.05, Mobile County, Alabama",94,1191,1063,115,289,332,2254,440.1647418864896
01097006406,"Census Tract 64.06, Mobile County, Alabama",44,1516,1471,49,301,262,2987,399.0551340353861
01097006407,"Census Tract 64.07, Mobile County, Alabama",106,674,585,91,246,164,1259,295.6552045880471
01097006501,"Census Tract 65.01, Mobile County, Alabama",79,476,617,77,142,125,1093,189.17980864775183
01097006502,"Census Tract 65.02, Mobile County, Alabama",122,2153,1817,86,566,409,3970,698.3101030344613
01097006600,"Census Tract 66, Mobile County, Alabama",27,698,780,40,327,269,1478,423.42649893458486
01097006701,"Census Tract 67.01, Mobile County, Alabama",39,813,618,62,277,224,1431,356.23728047468586
01097006702,"Census Tract 67.02, Mobile County, Alabama",119,545,516,133,127,150,1061,196.5426162439078
01097006801,"Census Tract 68.01, Mobile County, Alabama",95,939,690,124,335,193,1629,386.61867518266627
01097006802,"Census Tract 68.02, Mobile County, Alabama",140,290,330,130,130,160,620,206.15528128088303
01097006901,"Census Tract 69.01, Mobile County, Alabama",938,1144,1062,459,316,290,2206,428.90092095960813
01097006902,"Census Tract 69.02, Mobile County, Alabama",292,402,635,292,175,129,1037,217.40745157422734
01097007000,"Census Tract 70, Mobile County, Alabama",147,339,323,114,128,125,662,178.91059219621403
01097007101,"Census Tract 71.01, Mobile County, Alabama",20,806,755,24,216,163,1561,270.60118255469615
01097007102,"Census Tract 71.02, Mobile County, Alabama",17,530,493,29,250,178,1023,306.8941185490527
01097007103,"Census Tract 71.03, Mobile County, Alabama",0,359,136,12,114,98,495,150.33296378372907
01097007201,"Census Tract 72.01, Mobile County, Alabama",123,260,219,176,145,116,479,185.6906028855526
01097007202,"Census Tract 72.02, Mobile County, Alabama",35,301,195,30,113,71,496,133.4541119636259
01097007300,"Census Tract 73, Mobile County, Alabama",83,520,405,104,156,125,925,199.90247622278218
01097007400,"Census Tract 74, Mobile County, Alabama",0,391,269,12,179,138,660,226.01991062736045
01097007500,"Census Tract 75, Mobile County, Alabama",0,150,123,12,74,81,273,109.71326264403953
01097007600,"Census Tract 76, Mobile County, Alabama",0,297,241,12,169,102,538,197.39554199626699
01097007700,"Census Tract 77, Mobile County, Alabama",0,130,52,12,77,45,182,89.1852005660132
01097990000,"Census Tract 9900, Mobile County, Alabama",0,0,0,12,12,12,0,16.97056274847714
01099075600,"Census Tract 756, Monroe County, Alabama",0,112,109,12,71,79,221,106.21675950620975
01099075700,"Census Tract 757, Monroe County, Alabama",7,198,147,11,75,66,345,99.90495483208028
01099075800,"Census Tract 758, Monroe County, Alabama",7,275,174,12,134,114,449,175.93180496999398
01099075900,"Census Tract 759, Monroe County, Alabama",0,625,486,17,180,230,1111,292.0616373302047
01099076000,"Census Tract 760, Monroe County, Alabama",0,317,271,12,168,121,588,207.03864373589778
01099076100,"Census Tract 761, Monroe County, Alabama",21,808,907,32,188,207,1715,279.6301128276424
01099076200,"Census Tract 762, Monroe County, Alabama",0,223,96,12,106,51,319,117.63077828527702
01101000100,"Census Tract 1, Montgomery County, Alabama",15,15,13,11,12,13,28,17.69180601295413
01101000200,"Census Tract 2, Montgomery County, Alabama",7,70,0,13,87,12,70,87.82368700982668
01101000300,"Census Tract 3, Montgomery County, Alabama",26,120,131,30,46,73,251,86.28441342444185
01101000400,"Census Tract 4, Montgomery County, Alabama",97,668,569,76,175,198,1237,264.25177388240934
01101000500,"Census Tract 5, Montgomery County, Alabama",131,446,379,95,156,169,825,229.99347816840373
01101000600,"Census Tract 6, Montgomery County, Alabama",9,386,208,14,87,67,594,109.80892495603443
01101000700,"Census Tract 7, Montgomery County, Alabama",22,173,177,29,63,83,350,104.20172743289815
01101000900,"Census Tract 9, Montgomery County, Alabama",238,195,210,78,39,46,405,60.30754513325841
01101001000,"Census Tract 10, Montgomery County, Alabama",5,201,182,9,105,95,383,141.59802258506295
01101001100,"Census Tract 11, Montgomery County, Alabama",0,197,378,12,93,179,575,201.71762441591463
01101001200,"Census Tract 12, Montgomery County, Alabama",0,234,153,12,107,70,387,127.8632081562167
01101001300,"Census Tract 13, Montgomery County, Alabama",40,153,203,56,78,124,356,146.4923206178399
01101001400,"Census Tract 14, Montgomery County, Alabama",45,225,284,30,76,89,509,117.0341830406826
01101001500,"Census Tract 15, Montgomery County, Alabama",53,266,314,70,132,165,580,211.303099835284
01101001600,"Census Tract 16, Montgomery County, Alabama",212,296,455,158,119,235,751,263.41222446955646
01101001700,"Census Tract 17, Montgomery County, Alabama",10,640,449,16,252,154,1089,295.3303235362058
01101001800,"Census Tract 18, Montgomery County, Alabama",65,344,452,56,145,108,796,180.8009955724802
01101001900,"Census Tract 19, Montgomery County, Alabama",54,330,452,82,172,152,782,229.53866776645717
01101002000,"Census Tract 20, Montgomery County, Alabama",92,544,671,86,176,232,1215,291.20439557122074
01101002100,"Census Tract 21, Montgomery County, Alabama",25,461,499,26,156,151,960,217.11057090800531
01101002201,"Census Tract 22.01, Montgomery County, Alabama",0,589,453,12,200,234,1042,307.8246253956951
01101002202,"Census Tract 22.02, Montgomery County, Alabama",0,80,54,12,62,61,134,86.97700845625813
01101002300,"Census Tract 23, Montgomery County, Alabama",0,228,145,12,114,87,373,143.40502083260543
01101002400,"Census Tract 24, Montgomery County, Alabama",0,129,132,12,66,91,261,112.4144118874444
01101002500,"Census Tract 25, Montgomery County, Alabama",134,403,349,96,127,127,752,179.60512242138307
01101002600,"Census Tract 26, Montgomery County, Alabama",71,412,575,85,125,168,987,209.40152817016403
01101002700,"Census Tract 27, Montgomery County, Alabama",7,482,558,12,158,217,1040,268.4268988011447
01101002800,"Census Tract 28, Montgomery County, Alabama",91,694,501,72,189,127,1195,227.705950734714
01101002900,"Census Tract 29, Montgomery County, Alabama",136,1125,1102,127,309,376,2227,486.6795660390931
01101003000,"Census Tract 30, Montgomery County, Alabama",16,179,179,24,107,78,358,132.41223508422476
01101003100,"Census Tract 31, Montgomery County, Alabama",0,481,321,12,186,150,802,238.94769302087852
01101003200,"Census Tract 32, Montgomery County, Alabama",0,664,954,17,374,376,1618,530.3319715046416
01101003301,"Census Tract 33.01, Montgomery County, Alabama",0,493,404,12,230,150,897,274.5906043549196
01101003302,"Census Tract 33.02, Montgomery County, Alabama",0,559,581,17,189,213,1140,284.76305940202286
01101005101,"Census Tract 51.01, Montgomery County, Alabama",34,421,407,39,152,138,828,205.2997808084558
01101005102,"Census Tract 51.02, Montgomery County, Alabama",11,648,475,16,345,160,1123,380.2959373961284
01101005301,"Census Tract 53.01, Montgomery County, Alabama",91,240,154,67,98,50,394,110.01818031580054
01101005302,"Census Tract 53.02, Montgomery County, Alabama",217,331,264,106,89,95,595,130.17680284904833
01101005402,"Census Tract 54.02, Montgomery County, Alabama",259,835,775,167,274,301,1610,407.03439658092776
01101005403,"Census Tract 54.03, Montgomery County, Alabama",36,640,761,30,252,323,1401,409.67426084634604
01101005406,"Census Tract 54.06, Montgomery County, Alabama",29,659,1032,33,294,314,1691,430.1534609880525
01101005407,"Census Tract 54.07, Montgomery County, Alabama",23,307,238,17,156,112,545,192.04166214652486
01101005408,"Census Tract 54.08, Montgomery County, Alabama",70,922,737,51,222,155,1659,270.75634803269156
01101005409,"Census Tract 54.09, Montgomery County, Alabama",47,343,274,46,157,111,617,192.27584351654787
01101005410,"Census Tract 54.10, Montgomery County, Alabama",11,317,733,18,200,431,1050,475.1431363284121
01101005501,"Census Tract 55.01, Montgomery County, Alabama",6,310,149,13,111,70,459,131.2288078129189
01101005502,"Census Tract 55.02, Montgomery County, Alabama",111,725,499,162,218,158,1224,269.23595599399425
01101005503,"Census Tract 55.03, Montgomery County, Alabama",17,714,722,19,175,154,1436,233.11156127485398
01101005504,"Census Tract 55.04, Montgomery County, Alabama",3,170,224,5,44,56,394,71.21797525905943
01101005603,"Census Tract 56.03, Montgomery County, Alabama",691,1225,1292,223,384,316,2517,497.3047355495421
01101005604,"Census Tract 56.04, Montgomery County, Alabama",8,378,271,13,74,68,649,100.4987562112089
01101005605,"Census Tract 56.05, Montgomery County, Alabama",78,410,347,60,114,129,757,172.15400082484288
01101005606,"Census Tract 56.06, Montgomery County, Alabama",0,318,660,12,153,282,978,320.8317315977333
01101005607,"Census Tract 56.07, Montgomery County, Alabama",15,994,790,17,156,166,1784,227.7981562699751
01101005608,"Census Tract 56.08, Montgomery County, Alabama",17,275,247,19,78,66,522,102.17631819555841
01101005609,"Census Tract 56.09, Montgomery County, Alabama",0,692,413,12,237,159,1105,285.3944638566067
01101005610,"Census Tract 56.10, Montgomery County, Alabama",31,138,214,32,104,107,352,149.21461054467824
01101005611,"Census Tract 56.11, Montgomery County, Alabama",7,528,540,10,169,165,1068,236.19060099843094
01101005612,"Census Tract 56.12, Montgomery County, Alabama",24,347,325,29,77,88,672,116.93160394008115
01101005700,"Census Tract 57, Montgomery County, Alabama",0,143,118,12,66,73,261,98.41239759298622
01101005800,"Census Tract 58, Montgomery County, Alabama",0,85,136,12,60,97,221,114.0570032922135
01101005901,"Census Tract 59.01, Montgomery County, Alabama",257,367,248,216,173,105,615,202.37094653136353
01101005902,"Census Tract 59.02, Montgomery County, Alabama",20,413,370,33,182,155,783,239.0585702291386
01101006000,"Census Tract 60, Montgomery County, Alabama",469,355,296,199,209,134,651,248.26800035445567
01101006100,"Census Tract 61, Montgomery County, Alabama",0,266,244,12,99,113,510,150.23315213360866
01103000100,"Census Tract 1, Morgan County, Alabama",466,543,539,237,171,234,1082,289.82235938588315
01103000200,"Census Tract 2, Morgan County, Alabama",63,387,332,88,83,77,719,113.21660655575224
01103000300,"Census Tract 3, Morgan County, Alabama",182,386,375,129,129,141,761,191.10729970359583
01103000400,"Census Tract 4, Morgan County, Alabama",265,366,349,183,109,101,715,148.60013458944107
01103000600,"Census Tract 6, Morgan County, Alabama",280,365,227,199,163,171,592,236.24140195994434
01103000700,"Census Tract 7, Morgan County, Alabama",736,537,442,252,203,138,979,245.46486510293076
01103000800,"Census Tract 8, Morgan County, Alabama",316,212,252,151,134,115,464,176.58142597679972
01103000900,"Census Tract 9, Morgan County, Alabama",785,554,1120,311,256,315,1674,405.90762495917716
01103001000,"Census Tract 10, Morgan County, Alabama",415,678,392,227,240,131,1070,273.4245782661098
01103005101,"Census Tract 51.01, Morgan County, Alabama",193,685,519,148,185,194,1204,268.0690209628856
01103005103,"Census Tract 51.03, Morgan County, Alabama",0,187,108,12,113,54,295,125.23977004130916
01103005105,"Census Tract 51.05, Morgan County, Alabama",18,277,191,16,133,75,468,152.6892268629323
01103005106,"Census Tract 51.06, Morgan County, Alabama",61,583,693,63,207,218,1276,300.6210238822295
01103005107,"Census Tract 51.07, Morgan County, Alabama",128,559,504,171,173,250,1063,304.02138082707273
01103005108,"Census Tract 51.08, Morgan County, Alabama",124,316,364,120,105,128,680,165.55663683464942
01103005109,"Census Tract 51.09, Morgan County, Alabama",334,417,554,153,173,216,971,276.739950133695
01103005200,"Census Tract 52, Morgan County, Alabama",22,805,562,38,192,173,1367,258.44341740504825
01103005301,"Census Tract 53.01, Morgan County, Alabama",6,1096,767,10,321,172,1863,364.17715469260287
01103005302,"Census Tract 53.02, Morgan County, Alabama",114,338,402,128,110,135,740,174.14074767268
01103005303,"Census Tract 53.03, Morgan County, Alabama",62,355,314,59,112,111,669,157.68639763784319
01103005304,"Census Tract 53.04, Morgan County, Alabama",127,933,710,175,305,229,1643,381.4000524383813
01103005404,"Census Tract 54.04, Morgan County, Alabama",86,664,584,99,138,134,1248,192.35384061671346
01103005405,"Census Tract 54.05, Morgan County, Alabama",154,604,461,192,222,160,1065,273.64941074301623
01103005500,"Census Tract 55, Morgan County, Alabama",95,764,760,78,305,174,1524,351.14242124813114
01103005600,"Census Tract 56, Morgan County, Alabama",22,746,704,36,197,137,1450,239.95416228938393
01103005701,"Census Tract 57.01, Morgan County, Alabama",46,300,164,38,150,82,464,170.95028517086482
01103005702,"Census Tract 57.02, Morgan County, Alabama",301,407,914,250,142,238,1321,277.1425625918906
01105686800,"Census Tract 6868, Perry County, Alabama",0,118,84,12,89,83,202,121.69634341261039
01105687000,"Census Tract 6870, Perry County, Alabama",93,528,597,106,163,299,1125,340.5436829541843
01105687100,"Census Tract 6871, Perry County, Alabama",0,298,382,12,120,145,680,188.2153022471871
01107050000,"Census Tract 500, Pickens County, Alabama",94,623,436,47,118,113,1059,163.3799253274404
01107050100,"Census Tract 501, Pickens County, Alabama",19,338,284,36,122,107,622,162.27445886522005
01107050200,"Census Tract 502, Pickens County, Alabama",0,204,168,12,112,55,372,124.77579893553076
01107050300,"Census Tract 503, Pickens County, Alabama",34,358,260,46,120,114,618,165.51737068960466
01107050400,"Census Tract 504, Pickens County, Alabama",0,601,759,17,218,145,1360,261.81863951980193
01109188600,"Census Tract 1886, Pike County, Alabama",15,236,259,25,89,75,495,116.3872845288522
01109188700,"Census Tract 1887, Pike County, Alabama",0,221,247,12,88,92,468,127.31064370271639
01109188800,"Census Tract 1888, Pike County, Alabama",48,315,210,79,139,112,525,178.5077029150283
01109188900,"Census Tract 1889, Pike County, Alabama",33,396,481,55,177,175,877,248.90560459740556
01109189000,"Census Tract 1890, Pike County, Alabama",0,573,733,17,188,252,1306,314.40101781005734
01109189100,"Census Tract 1891, Pike County, Alabama",127,771,480,71,210,191,1251,283.86792703650053
01109189200,"Census Tract 1892, Pike County, Alabama",27,417,395,34,97,89,812,131.64345787011217
01109189300,"Census Tract 1893, Pike County, Alabama",91,423,313,62,117,107,736,158.54967675779096
01111000100,"Census Tract 1, Randolph County, Alabama",150,422,266,125,171,130,688,214.80456233516085
01111000200,"Census Tract 2, Randolph County, Alabama",43,414,467,61,109,174,881,205.32169880458324
01111000300,"Census Tract 3, Randolph County, Alabama",9,493,409,15,148,136,902,200.9975124224178
01111000400,"Census Tract 4, Randolph County, Alabama",129,587,519,141,146,155,1106,212.93426215618754
01111000500,"Census Tract 5, Randolph County, Alabama",18,453,356,31,157,136,809,207.7137453323684
01111000600,"Census Tract 6, Randolph County, Alabama",0,222,288,12,74,86,510,113.45483682946268
01113030200,"Census Tract 302, Russell County, Alabama",10,358,348,12,120,153,706,194.4453650771856
01113030300,"Census Tract 303, Russell County, Alabama",246,196,222,260,132,153,418,202.07176942858692
01113030401,"Census Tract 304.01, Russell County, Alabama",41,765,576,54,306,229,1341,382.2002093144377
01113030402,"Census Tract 304.02, Russell County, Alabama",105,339,402,92,114,122,741,166.97305171793442
01113030500,"Census Tract 305, Russell County, Alabama",0,270,416,12,86,112,686,141.20906486483082
01113030600,"Census Tract 306, Russell County, Alabama",589,980,1132,304,280,356,2112,452.91941888154895
01113030700,"Census Tract 307, Russell County, Alabama",107,648,301,106,205,142,949,249.3772243008571
01113030800,"Census Tract 308, Russell County, Alabama",12,438,372,23,173,165,810,239.06902768865731
01113030901,"Census Tract 309.01, Russell County, Alabama",119,848,619,112,229,261,1467,347.2203911062828
01113030902,"Census Tract 309.02, Russell County, Alabama",293,1580,1852,171,321,365,3432,486.0720111259236
01113031000,"Census Tract 310, Russell County, Alabama",77,355,367,93,106,133,722,170.07351351694948
01113031100,"Census Tract 311, Russell County, Alabama",0,109,153,12,48,92,262,103.76897416858277
01113031200,"Census Tract 312, Russell County, Alabama",29,238,285,43,116,117,523,164.7573974060042
01115040103,"Census Tract 401.03, St. Clair County, Alabama",15,1024,1354,27,247,250,2378,351.43847256667846
01115040104,"Census Tract 401.04, St. Clair County, Alabama",60,716,469,70,185,166,1185,248.55784035109414
01115040105,"Census Tract 401.05, St. Clair County, Alabama",321,799,321,210,232,124,1120,263.0589287593181
01115040106,"Census Tract 401.06, St. Clair County, Alabama",38,830,586,64,211,223,1416,307.001628660175
01115040201,"Census Tract 402.01, St. Clair County, Alabama",19,659,770,34,173,211,1429,272.8552729928451
01115040203,"Census Tract 402.03, St. Clair County, Alabama",40,620,690,55,202,257,1310,326.8837713928301
01115040204,"Census Tract 402.04, St. Clair County, Alabama",0,829,817,17,224,269,1646,350.0528531522061
01115040205,"Census Tract 402.05, St. Clair County, Alabama",78,502,520,96,232,252,1022,342.5317503531607
01115040300,"Census Tract 403, St. Clair County, Alabama",9,446,734,19,130,206,1180,243.58981916328113
01115040401,"Census Tract 404.01, St. Clair County, Alabama",58,747,422,57,236,146,1169,277.5103601669675
01115040402,"Census Tract 404.02, St. Clair County, Alabama",187,318,396,127,93,164,714,188.53381659532593
01115040501,"Census Tract 405.01, St. Clair County, Alabama",224,1521,1457,172,329,301,2978,445.9170326417236
01115040502,"Census Tract 405.02, St. Clair County, Alabama",167,1484,1010,123,290,274,2494,398.9686704491971
01117030102,"Census Tract 301.02, Shelby County, Alabama",50,500,447,65,111,96,947,146.7548977036201
01117030103,"Census Tract 301.03, Shelby County, Alabama",0,130,76,12,42,32,206,52.80151512977634
01117030211,"Census Tract 302.11, Shelby County, Alabama",0,454,373,12,101,112,827,150.81445554057476
01117030212,"Census Tract 302.12, Shelby County, Alabama",50,182,170,55,92,95,352,132.24598292575845
01117030213,"Census Tract 302.13, Shelby County, Alabama",319,618,340,252,148,120,958,190.53608582103286
01117030214,"Census Tract 302.14, Shelby County, Alabama",101,1127,1442,131,249,309,2569,396.8400181433319
01117030215,"Census Tract 302.15, Shelby County, Alabama",52,708,591,31,142,146,1299,203.66639388961548
01117030216,"Census Tract 302.16, Shelby County, Alabama",32,1056,974,35,349,218,2030,411.4911906711977
01117030217,"Census Tract 302.17, Shelby County, Alabama",85,636,726,107,160,150,1362,219.31712199461307
01117030303,"Census Tract 303.03, Shelby County, Alabama",78,765,733,69,197,227,1498,300.5628054167714
01117030304,"Census Tract 303.04, Shelby County, Alabama",98,694,669,78,196,162,1363,254.2833065696606
01117030305,"Census Tract 303.05, Shelby County, Alabama",33,580,437,49,121,89,1017,150.20652449211386
01117030306,"Census Tract 303.06, Shelby County, Alabama",0,417,350,12,101,104,767,144.97241116847025
01117030314,"Census Tract 303.14, Shelby County, Alabama",277,226,273,275,129,116,499,173.4848696572701
01117030315,"Census Tract 303.15, Shelby County, Alabama",661,551,517,235,298,285,1068,412.34572872772674
01117030316,"Census Tract 303.16, Shelby County, Alabama",222,535,820,66,132,223,1355,259.1389588618431
01117030317,"Census Tract 303.17, Shelby County, Alabama",75,499,502,83,128,145,1001,193.4140636044856
01117030319,"Census Tract 303.19, Shelby County, Alabama",206,299,271,181,98,95,570,136.48809471891678
01117030320,"Census Tract 303.20, Shelby County, Alabama",237,702,787,215,143,127,1489,191.25375813301028
01117030330,"Census Tract 303.30, Shelby County, Alabama",84,618,616,92,163,195,1234,254.15349692656207
01117030331,"Census Tract 303.31, Shelby County, Alabama",94,595,519,80,106,123,1114,162.3730273167314
01117030332,"Census Tract 303.32, Shelby County, Alabama",6,143,111,12,46,47,254,65.76473218982953
01117030333,"Census Tract 303.33, Shelby County, Alabama",69,683,453,53,136,135,1136,191.62724232217087
01117030334,"Census Tract 303.34, Shelby County, Alabama",45,433,684,40,81,115,1117,140.6627171641441
01117030336,"Census Tract 303.36, Shelby County, Alabama",152,1323,1157,181,242,224,2480,329.75748664738455
01117030337,"Census Tract 303.37, Shelby County, Alabama",99,149,286,67,80,126,435,149.25146565444507
01117030340,"Census Tract 303.40, Shelby County, Alabama",190,832,713,127,181,171,1545,249.0020080240318
01117030341,"Census Tract 303.41, Shelby County, Alabama",327,363,334,163,122,124,697,173.95401691251627
01117030342,"Census Tract 303.42, Shelby County, Alabama",45,331,312,40,93,69,643,115.80155439371269
01117030344,"Census Tract 303.44, Shelby County, Alabama",50,438,266,55,119,91,704,149.80654191322887
01117030345,"Census Tract 303.45, Shelby County, Alabama",235,426,272,198,120,92,698,151.2084653714864
01117030405,"Census Tract 304.05, Shelby County, Alabama",35,98,75,38,50,44,173,66.60330322138685
01117030406,"Census Tract 304.06, Shelby County, Alabama",148,421,233,163,199,100,654,222.71281956816046
01117030407,"Census Tract 304.07, Shelby County, Alabama",7,70,37,8,43,31,107,53.009433122794285
01117030408,"Census Tract 304.08, Shelby County, Alabama",208,301,234,177,168,119,535,205.8761763779384
01117030501,"Census Tract 305.01, Shelby County, Alabama",118,1035,928,92,276,196,1963,338.514401466171
01117030502,"Census Tract 305.02, Shelby County, Alabama",27,355,314,30,79,80,669,112.43220179290273
01117030604,"Census Tract 306.04, Shelby County, Alabama",655,957,1302,333,283,406,2259,494.8989795907848
01117030605,"Census Tract 306.05, Shelby County, Alabama",135,1067,1329,114,320,391,2396,505.2534017698446
01117030607,"Census Tract 306.07, Shelby County, Alabama",256,838,753,245,284,203,1591,349.09167850293994
01117030608,"Census Tract 306.08, Shelby County, Alabama",22,346,362,34,104,119,708,158.04113388608675
01117030609,"Census Tract 306.09, Shelby County, Alabama",527,1139,1194,344,261,324,2333,416.0492759277439
01117030701,"Census Tract 307.01, Shelby County, Alabama",39,440,667,35,141,153,1107,208.06249061279644
01117030703,"Census Tract 307.03, Shelby County, Alabama",79,421,547,108,172,144,968,224.32119828495925
01117030704,"Census Tract 307.04, Shelby County, Alabama",0,413,183,12,113,85,596,141.40014144264495
01117030800,"Census Tract 308, Shelby County, Alabama",81,443,482,54,100,96,925,138.62178760930766
01117030900,"Census Tract 309, Shelby County, Alabama",0,277,130,12,90,74,407,116.51609330903607
01117980000,"Census Tract 9800, Shelby County, Alabama",0,0,0,12,12,12,0,16.97056274847714
01119011300,"Census Tract 113, Sumter County, Alabama",8,511,676,17,183,130,1187,224.47494292236718
01119011400,"Census Tract 114, Sumter County, Alabama",27,184,169,36,94,61,353,112.05802068571441
01119011500,"Census Tract 115, Sumter County, Alabama",1,585,274,6,167,87,859,188.30294740125552
01119011600,"Census Tract 116, Sumter County, Alabama",0,41,30,12,36,26,71,44.40720662234904
01121010101,"Census Tract 101.01, Talladega County, Alabama",143,702,424,162,163,107,1126,194.982050455933
01121010102,"Census Tract 101.02, Talladega County, Alabama",0,708,576,12,206,198,1284,285.72714256787015
01121010201,"Census Tract 102.01, Talladega County, Alabama",18,479,172,34,215,120,651,246.22144504490262
01121010202,"Census Tract 102.02, Talladega County, Alabama",21,354,550,36,127,159,904,203.49447166937975
01121010301,"Census Tract 103.01, Talladega County, Alabama",92,355,522,113,142,178,877,227.7015590636129
01121010302,"Census Tract 103.02, Talladega County, Alabama",0,440,328,12,167,117,768,203.90684147423792
01121010400,"Census Tract 104, Talladega County, Alabama",73,321,280,91,145,112,601,183.2184488527288
01121010500,"Census Tract 105, Talladega County, Alabama",0,234,121,12,111,98,355,148.07092894960846
01121010600,"Census Tract 106, Talladega County, Alabama",26,530,551,37,167,161,1081,231.96982562393757
01121010700,"Census Tract 107, Talladega County, Alabama",167,170,123,58,74,63,293,97.18538984847466
01121010900,"Census Tract 109, Talladega County, Alabama",24,161,331,46,72,144,492,160.99689437998487
01121011000,"Census Tract 110, Talladega County, Alabama",251,178,210,245,90,105,388,138.2931668593933
01121011100,"Census Tract 111, Talladega County, Alabama",0,267,745,12,107,318,1012,335.5190009522561
01121011200,"Census Tract 112, Talladega County, Alabama",9,199,331,13,77,91,530,119.20570456148481
01121011300,"Census Tract 113, Talladega County, Alabama",145,585,618,190,234,211,1203,315.0825288714054
01121011400,"Census Tract 114, Talladega County, Alabama",0,424,361,12,133,172,785,217.42354978244651
01121011500,"Census Tract 115, Talladega County, Alabama",0,756,504,17,176,161,1260,238.53092042752024
01121011600,"Census Tract 116, Talladega County, Alabama",0,651,763,12,173,294,1414,341.1231449198368
01121011700,"Census Tract 117, Talladega County, Alabama",45,326,414,68,93,103,740,138.77319625922004
01121011800,"Census Tract 118, Talladega County, Alabama",19,242,218,36,104,91,460,138.19189556555045
01121011900,"Census Tract 119, Talladega County, Alabama",77,433,245,104,197,90,678,216.5848563496534
01121012000,"Census Tract 120, Talladega County, Alabama",0,174,181,12,63,81,355,102.61578825892242
01123961900,"Census Tract 9619, Tallapoosa County, Alabama",5,330,255,8,101,79,585,128.22636234409833
01123962000,"Census Tract 9620, Tallapoosa County, Alabama",62,447,415,66,143,99,862,173.92527130926086
01123962100,"Census Tract 9621, Tallapoosa County, Alabama",40,405,589,50,139,165,994,215.74522010927612
01123962200,"Census Tract 9622, Tallapoosa County, Alabama",14,582,557,31,184,140,1139,231.2055362658948
01123962300,"Census Tract 9623, Tallapoosa County, Alabama",230,593,771,109,210,161,1364,264.6148144001012
01123962400,"Census Tract 9624, Tallapoosa County, Alabama",80,516,441,57,177,109,957,207.87015177749788
01123962501,"Census Tract 9625.01, Tallapoosa County, Alabama",0,338,191,12,139,84,529,162.40997506310995
01123962502,"Census Tract 9625.02, Tallapoosa County, Alabama",8,176,134,15,88,67,310,110.60289327137876
01123962600,"Census Tract 9626, Tallapoosa County, Alabama",24,207,208,18,90,88,415,125.8729518204765
01123962700,"Census Tract 9627, Tallapoosa County, Alabama",0,685,629,17,229,159,1314,278.78665678256556
01125010101,"Census Tract 101.01, Tuscaloosa County, Alabama",10,628,727,18,116,226,1355,254.03149411047443
01125010102,"Census Tract 101.02, Tuscaloosa County, Alabama",83,336,266,127,127,101,602,162.265215003093
01125010103,"Census Tract 101.03, Tuscaloosa County, Alabama",48,758,587,77,271,201,1345,337.40480138848056
01125010201,"Census Tract 102.01, Tuscaloosa County, Alabama",0,433,605,12,174,208,1038,271.1825953117198
01125010202,"Census Tract 102.02, Tuscaloosa County, Alabama",237,1450,995,199,269,186,2445,327.04281065328433
01125010203,"Census Tract 102.03, Tuscaloosa County, Alabama",14,150,352,22,64,159,502,171.39719951037708
01125010204,"Census Tract 102.04, Tuscaloosa County, Alabama",194,490,642,166,137,279,1132,310.82149217838844
01125010301,"Census Tract 103.01, Tuscaloosa County, Alabama",118,687,876,80,130,221,1563,256.40007800310826
01125010302,"Census Tract 103.02, Tuscaloosa County, Alabama",195,328,393,149,100,105,721,145
01125010303,"Census Tract 103.03, Tuscaloosa County, Alabama",4,263,404,18,118,124,667,171.1724276862369
01125010403,"Census Tract 104.03, Tuscaloosa County, Alabama",109,299,615,147,164,178,914,242.03305559365234
01125010404,"Census Tract 104.04, Tuscaloosa County, Alabama",57,273,383,85,106,90,656,139.05394636614957
01125010405,"Census Tract 104.05, Tuscaloosa County, Alabama",85,850,380,93,189,108,1230,217.68095920406083
01125010406,"Census Tract 104.06, Tuscaloosa County, Alabama",83,798,590,111,184,146,1388,234.88720697390056
01125010407,"Census Tract 104.07, Tuscaloosa County, Alabama",0,305,313,12,134,149,618,200.39211561336438
01125010500,"Census Tract 105, Tuscaloosa County, Alabama",303,283,115,173,122,70,398,140.65560778013793
01125010601,"Census Tract 106.01, Tuscaloosa County, Alabama",145,514,324,144,151,99,838,180.5602392554906
01125010602,"Census Tract 106.02, Tuscaloosa County, Alabama",13,1284,939,18,352,332,2223,483.86775052693895
01125010701,"Census Tract 107.01, Tuscaloosa County, Alabama",59,684,1011,51,196,177,1695,264.09278672466615
01125010702,"Census Tract 107.02, Tuscaloosa County, Alabama",70,813,978,97,173,224,1791,283.0282671395209
01125010703,"Census Tract 107.03, Tuscaloosa County, Alabama",8,333,493,9,88,159,826,181.72781845386248
01125010802,"Census Tract 108.02, Tuscaloosa County, Alabama",52,545,555,46,173,197,1100,262.17932794177347
01125010803,"Census Tract 108.03, Tuscaloosa County, Alabama",126,353,452,113,132,178,805,221.60324907365415
01125010804,"Census Tract 108.04, Tuscaloosa County, Alabama",125,363,306,84,100,131,669,164.80594649465777
01125011200,"Census Tract 112, Tuscaloosa County, Alabama",138,45,31,84,43,36,76,56.08029957123981
01125011401,"Census Tract 114.01, Tuscaloosa County, Alabama",40,83,44,42,46,48,127,66.48308055437865
01125011402,"Census Tract 114.02, Tuscaloosa County, Alabama",116,27,40,179,45,43,67,62.24146527838174
01125011600,"Census Tract 116, Tuscaloosa County, Alabama",12,249,241,19,138,105,490,173.4041521994211
01125011701,"Census Tract 117.01, Tuscaloosa County, Alabama",94,408,271,130,175,99,679,201.06217943710845
01125011703,"Census Tract 117.03, Tuscaloosa County, Alabama",0,641,802,12,178,235,1443,294.8033242689098
01125011800,"Census Tract 118, Tuscaloosa County, Alabama",0,235,270,12,164,231,505,283.2966642938106
01125011901,"Census Tract 119.01, Tuscaloosa County, Alabama",185,301,301,161,122,127,602,176.1050822662424
01125011902,"Census Tract 119.02, Tuscaloosa County, Alabama",58,304,228,86,155,124,532,198.4968513604183
01125012000,"Census Tract 120, Tuscaloosa County, Alabama",0,77,0,12,90,12,77,90.79647570252934
01125012100,"Census Tract 121, Tuscaloosa County, Alabama",84,398,291,66,188,153,689,242.39018131929353
01125012303,"Census Tract 123.03, Tuscaloosa County, Alabama",112,604,766,124,193,291,1370,349.1847648452034
01125012304,"Census Tract 123.04, Tuscaloosa County, Alabama",28,264,398,30,109,186,662,215.58524995926786
01125012305,"Census Tract 123.05, Tuscaloosa County, Alabama",21,678,667,35,190,173,1345,256.96108654813867
01125012403,"Census Tract 124.03, Tuscaloosa County, Alabama",25,460,312,31,195,187,772,270.1740179958095
01125012404,"Census Tract 124.04, Tuscaloosa County, Alabama",157,392,158,167,191,137,550,235.05318547086316
01125012405,"Census Tract 124.05, Tuscaloosa County, Alabama",64,685,779,76,266,329,1464,423.0803706153241
01125012501,"Census Tract 125.01, Tuscaloosa County, Alabama",0,230,177,12,87,90,407,125.1758762701504
01125012502,"Census Tract 125.02, Tuscaloosa County, Alabama",0,1030,1012,17,447,238,2042,506.4118876961717
01125012503,"Census Tract 125.03, Tuscaloosa County, Alabama",39,584,484,42,164,160,1068,229.12005586591496
01125012600,"Census Tract 126, Tuscaloosa County, Alabama",23,162,14,35,119,22,176,121.01652779682617
01125012700,"Census Tract 127, Tuscaloosa County, Alabama",786,652,517,272,182,223,1169,287.8419705324434
01125012800,"Census Tract 128, Tuscaloosa County, Alabama",0,525,260,12,159,113,785,195.0640920313116
01127020100,"Census Tract 201, Walker County, Alabama",6,297,222,18,170,130,519,214.00934559032697
01127020200,"Census Tract 202, Walker County, Alabama",74,434,593,76,113,129,1027,171.49344010777787
01127020300,"Census Tract 203, Walker County, Alabama",221,801,616,204,260,207,1417,332.3386826717588
01127020400,"Census Tract 204, Walker County, Alabama",192,197,279,91,61,74,476,95.90099061010788
01127020600,"Census Tract 206, Walker County, Alabama",51,277,378,79,131,174,655,217.8003673091485
01127020700,"Census Tract 207, Walker County, Alabama",145,304,281,79,124,136,585,184.04347312523745
01127020800,"Census Tract 208, Walker County, Alabama",34,683,587,51,152,140,1270,206.64946164943183
01127020900,"Census Tract 209, Walker County, Alabama",0,825,360,17,202,176,1185,267.9178978717174
01127021000,"Census Tract 210, Walker County, Alabama",17,318,555,17,143,240,873,279.3725111745964
01127021100,"Census Tract 211, Walker County, Alabama",1,372,318,5,93,90,690,129.41792766073794
01127021200,"Census Tract 212, Walker County, Alabama",11,239,232,20,151,141,471,206.59622455408038
01127021300,"Census Tract 213, Walker County, Alabama",6,507,390,9,183,116,897,216.6679487141557
01127021400,"Census Tract 214, Walker County, Alabama",116,420,516,105,124,201,936,236.17154782064668
01127021500,"Census Tract 215, Walker County, Alabama",0,380,264,12,113,91,644,145.08618128546908
01127021600,"Census Tract 216, Walker County, Alabama",0,215,142,12,45,57,357,72.62231062146122
01127021700,"Census Tract 217, Walker County, Alabama",0,535,559,12,148,135,1094,200.32224040280698
01127021800,"Census Tract 218, Walker County, Alabama",88,384,399,106,148,149,783,210.01190442448734
01127021900,"Census Tract 219, Walker County, Alabama",20,255,122,28,76,70,377,103.32473082471591
01129043900,"Census Tract 439, Washington County, Alabama",0,284,285,12,83,102,569,131.50285168010618
01129044000,"Census Tract 440, Washington County, Alabama",94,419,237,143,129,107,656,167.6007159889241
01129044100,"Census Tract 441, Washington County, Alabama",6,570,414,9,160,122,984,201.20636172845033
01129044200,"Census Tract 442, Washington County, Alabama",0,371,769,12,170,171,1140,241.12444919584576
01129044300,"Census Tract 443, Washington County, Alabama",20,234,205,26,101,66,439,120.65239326262865
01131034700,"Census Tract 347, Wilcox County, Alabama",0,108,392,12,56,171,500,179.93609976877903
01131034800,"Census Tract 348, Wilcox County, Alabama",0,677,531,12,186,189,1208,265.1735280905694
01131035100,"Census Tract 351, Wilcox County, Alabama",0,258,372,12,95,142,630,170.84788555905513
01131035200,"Census Tract 352, Wilcox County, Alabama",3,190,49,5,98,41,239,106.23088063270491
01133965501,"Census Tract 9655.01, Winston County, Alabama",0,313,337,12,84,131,650,155.6181223379848
01133965502,"Census Tract 9655.02, Winston County, Alabama",0,161,140,12,78,73,301,106.83164325236227
01133965503,"Census Tract 9655.03, Winston County, Alabama",34,212,299,54,88,103,511,135.47324459095236
01133965600,"Census Tract 9656, Winston County, Alabama",153,655,473,129,211,149,1128,258.3060200614767
01133965700,"Census Tract 9657, Winston County, Alabama",78,501,525,70,124,129,1026,178.932948335403
01133965800,"Census Tract 9658, Winston County, Alabama",117,414,423,112,92,122,837,152.80052355931247
01133965900,"Census Tract 9659, Winston County, Alabama",22,267,206,39,72,65,473,97
